"";"P";"Player";"Age";"Salary";"GP";"G";"GA";"PlusMin";"NHL"
"1";"RW";"Aaron Downey";33;0,52;56;0;3;0;3
"2";"D";"Aaron Johnson";24;0,48;30;0;2;2;2
"3";"D";"Aaron Miller";36;1,5;57;1;8;-1;9
"4";"D";"Aaron Rome";24;0,5;17;1;1;-4;2
"5";"LW";"Aaron Voros";26;0,39;55;7;7;-7;14
"6";"D";"Aaron Ward";34;2,75;65;5;8;9;13
"7";"LW";"Adam Berti";21;0,01;2;0;0;0;0
"8";"RW";"Adam Burish";24;0,57;81;4;4;-13;8
"9";"D";"Adam Foote";36;4,6;75;1;15;2;16
"10";"RW";"Adam Hall";27;0,52;46;2;4;-2;6
"11";"C";"Adam Mair";28;0,75;72;5;12;-2;17
"12";"RW";"Adam Pineault";21;0,01;3;0;0;-2;0
"13";"D";"Adrian Aucoin";34;4;76;10;25;13;35
"14";"D";"Alain Nasreddine";32;0,14;6;0;0;-4;0
"15";"RW";"Ales Hemsky";24;3,6;74;20;51;-9;71
"16";"RW";"Ales Kotalik";29;2,5;79;23;20;-5;43
"17";"G";"Alex Auld";26;0,6;32;0;0;0;0
"18";"RW";"Alex Burrows";26;0,48;82;12;19;11;31
"19";"D";"Alex Edler";21;0,54;75;8;12;6;20
"20";"LW";"Alex Foster";23;0,03;3;0;0;0;0
"21";"D";"Alex Goligoski";22;0,07;3;0;2;2;2
"22";"RW";"Alex Kovalev";34;4,5;82;35;49;18;84
"23";"LW";"Alex Ovechkin";22;3,83;82;65;47;28;112
"24";"C";"Alex Steen";23;0,9;76;15;27;0;42
"25";"LW";"Alex Tanguay";28;5,38;78;18;40;11;58
"26";"LW";"Alexander Frolov";25;3;71;23;44;1;67
"27";"C";"Alexander Nikulin";22;0,02;2;0;0;-2;0
"28";"RW";"Alexander Radulov";21;0,69;81;26;32;7;58
"29";"LW";"Alexander Semin";23;1,2;63;26;16;-18;42
"30";"D";"Alexandre Picard";22;0,2;27;3;3;-12;6
"31";"LW";"Alexei Ponikarovsky";27;1,57;66;18;17;3;35
"32";"D";"Alexei Semenov";26;0,65;22;1;3;-8;4
"33";"D";"Alexei Zhitnik";35;3,5;65;3;5;-8;8
"34";"D";"Allan Rourke";27;0,09;13;0;0;-1;0
"35";"D";"Anders Eriksson";32;1,5;61;1;17;-5;18
"36";"RW";"Andre Roy";32;0,86;63;4;3;-1;7
"37";"C";"Andreas Karlsson";32;0,5;58;2;2;-7;4
"38";"D";"Andreas Lilja";32;1;79;2;10;-2;12
"39";"RW";"Andrei Kostitsyn";22;0,61;78;26;27;15;53
"40";"D";"Andrei Markov";29;5,75;82;16;42;1;58
"41";"D";"Andrei Zyuzin";29;1,48;32;2;3;-11;5
"42";"D";"Andrej Meszaros";22;0,98;82;9;27;5;36
"43";"D";"Andrej Sekera";21;0,3;37;2;6;5;8
"44";"D";"Andrew Alberts";26;1,1;35;0;2;4;2
"45";"LW";"Andrew Brunette";34;1,6;82;19;40;5;59
"46";"C";"Andrew Cogliano";20;1,13;82;18;27;1;45
"47";"C";"Andrew Ebbett";24;0,03;3;0;0;3;0
"48";"D";"Andrew Ference";28;1,24;59;1;14;-14;15
"49";"LW";"Andrew Ladd";22;1,78;63;14;16;13;30
"50";"C";"Andrew Murray";26;0,26;39;6;4;-1;10
"51";"LW";"Andrew Peters";27;0,5;44;1;1;-4;2
"52";"G";"Andrew Raycroft";27;2;19;0;0;0;0
"53";"D";"Andy Greene";25;0,6;59;2;8;0;10
"54";"C";"Andy Hilbert";26;0,65;70;8;8;2;16
"55";"C";"Andy McDonald";30;3,33;82;18;34;-21;52
"56";"D";"Andy Sutton";32;2,5;58;1;7;-6;8
"57";"D";"Andy Wozniewski";27;0,34;48;2;7;5;9
"58";"G";"Antero Niittymaki";27;1,07;28;0;0;0;0
"59";"RW";"Anthony Stewart";22;0,18;26;0;1;-1;1
"60";"C";"Antoine Vermette";25;1,07;81;24;29;3;53
"61";"D";"Anton Stralman";21;0,5;50;3;6;-10;9
"62";"D";"Anton Volchenkov";25;2,1;67;1;14;14;15
"63";"LW";"Antti Miettinen";27;0,88;69;15;19;4;34
"64";"LW";"Antti Pihlstrom";23;0,01;1;0;0;-1;0
"65";"C";"Anze Kopitar";20;0,96;82;32;45;-15;77
"66";"RW";"Arron Asham";29;0,7;77;6;4;-6;10
"67";"RW";"B.J. Crombeen";22;0,07;8;0;2;1;2
"68";"D";"Barret Jackman";26;2,2;78;2;14;-12;16
"69";"RW";"Barry Tallackson";24;0,03;3;0;0;0;0
"70";"LW";"Ben Eager";23;0,55;32;0;2;-9;2
"71";"C";"Ben Guite";29;0,48;79;11;11;1;22
"72";"RW";"Ben Ondrus";25;0,02;3;0;0;-1;0
"73";"C";"Ben Walter";23;0,05;8;1;0;-1;1
"74";"LW";"Benoit Pouliot";21;0,26;11;2;1;-1;3
"75";"RW";"Bill Guerin";37;4,5;81;23;21;-15;44
"76";"C";"Bill Thomas";24;0,08;7;0;0;-2;0
"77";"C";"Blair Betts";27;0,62;75;2;5;-4;7
"78";"C";"Blair Jones";21;0,02;4;0;0;0;0
"79";"RW";"Blake Comeau";21;0,38;51;8;7;1;15
"80";"D";"Bobby Allen";29;0,5;19;0;0;-2;0
"81";"C";"Bobby Holik";37;4,25;82;15;19;-14;34
"82";"RW";"Bobby Ryan";20;0,61;23;5;5;-1;10
"83";"D";"Boris Valabik";21;0,1;7;0;0;-2;0
"84";"C";"Boyd Devereaux";29;0,55;62;7;11;-6;18
"85";"C";"Boyd Gordon";24;0,65;67;7;9;5;16
"86";"C";"Brad Boyes";25;1,6;82;43;22;1;65
"87";"LW";"Brad Isbister";30;0,52;55;6;5;-4;11
"88";"LW";"Brad Larsen";30;0,51;62;1;3;-17;4
"89";"D";"Brad Lukowich";31;1,25;59;1;6;-15;7
"90";"LW";"Brad May";36;0,6;61;3;1;2;4
"91";"C";"Brad Richards";27;7,8;74;20;42;-27;62
"92";"C";"Brad Richardson";22;0,3;22;2;3;-3;5
"93";"D";"Brad Stuart";28;3,5;72;6;17;-10;23
"94";"LW";"Brad Winchester";26;0,48;41;1;2;-9;3
"95";"LW";"Brady Murray";23;0,07;4;1;0;-2;1
"96";"RW";"Brandon Bochenski";25;0,6;40;3;10;6;13
"97";"C";"Brandon Dubinsky";21;0,64;82;14;26;8;40
"98";"LW";"Brandon Nolan";24;0,04;6;0;1;-2;1
"99";"D";"Branislav Mezei";27;0,85;57;2;2;-13;4
"100";"RW";"Branko Radivojevic";27;0,68;73;7;10;-14;17
"101";"D";"Braydon Coburn";22;0,94;78;9;27;17;36
"102";"D";"Brendan Bell";24;0,06;2;0;0;-2;0
"103";"C";"Brendan Morrison";32;3,2;39;9;16;-3;25
"104";"LW";"Brendan Shanahan";38;2,5;73;23;23;-2;46
"105";"D";"Brendan Witt";32;2,8;59;2;5;-8;7
"106";"LW";"Brenden Morrow";28;4,1;82;32;42;23;74
"107";"D";"Brent Burns";22;0,88;82;15;28;12;43
"108";"G";"Brent Johnson";30;0,8;19;0;0;0;0
"109";"D";"Brent Seabrook";22;0,94;82;9;23;13;32
"110";"D";"Brent Sopel";30;1,5;58;1;19;9;20
"111";"D";"Bret Hedican";37;2,43;66;2;15;17;17
"112";"D";"Brett Clark";31;1,5;57;5;16;5;21
"113";"D";"Brett Lebda";25;0,55;78;3;11;-1;14
"114";"C";"Brett McLean";29;1,7;67;14;23;-5;37
"115";"LW";"Brett Sterling";23;0,12;13;1;2;-2;3
"116";"G";"Brian Boucher";30;0,11;5;0;0;0;0
"117";"C";"Brian Boyle";23;0,07;8;4;1;4;5
"118";"D";"Brian Campbell";28;1,75;83;8;54;8;62
"119";"G";"Brian Elliott";22;0,06;1;0;0;0;0
"120";"RW";"Brian Gionta";28;4;82;22;31;1;53
"121";"D";"Brian Lee";20;0,09;6;0;1;1;1
"122";"RW";"Brian McGrattan";26;0,55;38;0;3;0;3
"123";"D";"Brian Pothier";30;2,5;38;5;9;5;14
"124";"D";"Brian Rafalski";34;6;73;13;42;27;55
"125";"LW";"Brian Rolston";34;2,43;81;31;28;-1;59
"126";"C";"Brian Sutherby";25;0,8;50;1;1;-4;2
"127";"RW";"Brian Willsie";29;0,9;53;4;8;-8;12
"128";"C";"Brooks Laich";24;0,72;82;21;16;-3;37
"129";"D";"Brooks Orpik";27;1,07;78;1;10;11;11
"130";"D";"Bruno Gervais";23;0,48;60;0;13;-5;13
"131";"D";"Bryan Allen";27;2,25;73;2;14;5;16
"132";"D";"Bryan Berard";30;0,7;54;5;17;-17;22
"133";"LW";"Bryan Bickell";21;0,03;4;0;0;-1;0
"134";"C";"Bryan Little";20;0,53;48;6;10;-2;16
"135";"D";"Bryan McCabe";32;7,15;54;5;18;-2;23
"136";"C";"Bryan Smolinski";36;2;64;8;17;-6;25
"137";"D";"Bryan Young";21;0,01;2;0;0;-1;0
"138";"D";"Bryce Salvador";31;1,5;64;1;10;12;11
"139";"C";"Byron Ritchie";30;0,68;71;3;8;-10;11
"140";"RW";"Cal Clutterbuck";20;0,04;2;0;0;0;0
"141";"D";"Cam Barker";21;1,6;45;6;12;-3;18
"142";"RW";"Cam Janssen";23;0,55;12;0;1;-1;1
"143";"G";"Cam Ward";23;2;69;0;1;0;1
"144";"G";"Carey Price";20;1,88;41;0;2;0;2
"145";"D";"Carlo Colaiacovo";24;1,05;28;2;4;-4;6
"146";"D";"Casey Borer";22;0,07;11;1;2;-3;3
"147";"LW";"Clarke MacArthur";22;0,32;37;8;7;3;15
"148";"C";"Claude Giroux";19;0,03;2;0;0;-2;0
"149";"D";"Clay Wilson";24;0,06;7;1;1;3;2
"150";"C";"Cody Bass";20;0,3;21;2;2;-1;4
"151";"RW";"Cody McCormick";24;0,38;40;2;2;5;4
"152";"LW";"Cody McLeod";23;0,28;49;4;5;-6;9
"153";"RW";"Colby Armstrong";25;1,2;72;13;22;4;35
"154";"C";"Colin Fraser";22;0,05;5;0;0;-2;0
"155";"LW";"Colin Stuart";25;0,1;18;3;2;2;5
"156";"D";"Colin White";30;3;57;2;8;-5;10
"157";"RW";"Colton Orr";25;0,52;74;1;1;-13;2
"158";"C";"Connor James";25;0,08;13;1;0;-2;1
"159";"G";"Corey Crawford";23;0,11;5;0;0;0;0
"160";"C";"Corey Locke";23;0,01;1;0;0;-1;0
"161";"RW";"Corey Perry";22;0,62;70;29;25;12;54
"162";"D";"Cory Murphy";29;0,78;47;2;15;0;17
"163";"D";"Cory Sarich";29;3,9;80;2;5;2;7
"164";"LW";"Cory Stillman";34;1,75;79;24;41;-15;65
"165";"RW";"Craig Adams";30;0,6;75;4;7;-16;11
"166";"G";"Craig Anderson";26;0,52;17;0;1;0;1
"167";"C";"Craig Conroy";36;2,85;79;12;22;6;34
"168";"C";"Craig MacDonald";30;0,47;65;2;9;-10;11
"169";"D";"Craig Rivet";33;3,5;74;5;30;3;35
"170";"RW";"Craig Weller";26;0,48;59;3;8;-7;11
"171";"G";"Cristobal Huet";32;2,75;52;0;2;0;2
"172";"C";"Curtis Brown";31;0,7;33;5;4;4;9
"173";"LW";"Curtis Glencross";25;0,52;62;15;10;8;25
"174";"G";"Curtis Joseph";40;0,65;9;0;0;0;0
"175";"G";"Curtis McElhinney";24;0,26;5;0;0;0;0
"176";"G";"Curtis Sanford";28;0,6;16;0;1;0;1
"177";"LW";"Chad Kilger";31;0,8;53;10;7;1;17
"178";"RW";"Chad LaRose";25;0,5;58;11;12;6;23
"179";"G";"Chris Beckford-Tseu";23;0,04;1;0;0;0;0
"180";"LW";"Chris Bourque";21;0,02;4;0;0;0;0
"181";"D";"Chris Campoli";23;0,6;46;4;14;-1;18
"182";"RW";"Chris Clark";31;1,1;18;5;4;0;9
"183";"RW";"Chris Conner";24;0,16;22;3;2;0;5
"184";"D";"Chris Chelios";45;1,15;69;3;9;11;12
"185";"C";"Chris Drury";31;7,1;82;25;33;-3;58
"186";"C";"Chris Gratton";32;1,5;60;10;11;-7;21
"187";"C";"Chris Higgins";24;1,5;82;27;25;0;52
"188";"C";"Chris Kelly";27;1,26;75;11;19;3;30
"189";"LW";"Chris Kunitz";28;1,15;82;21;29;8;50
"190";"G";"Chris Mason";31;1,25;51;0;1;0;1
"191";"C";"Chris Minard";26;0,13;15;1;1;-1;2
"192";"RW";"Chris Neil";28;1,1;68;6;14;-3;20
"193";"G";"Chris Osgood";35;0,8;43;0;3;0;3
"194";"D";"Chris Phillips";29;3,5;81;5;13;15;18
"195";"D";"Chris Pronger";33;5,51;72;12;31;-1;43
"196";"LW";"Chris Simon";35;0,49;38;1;2;-2;3
"197";"RW";"Chris Thorburn";24;0,48;73;5;13;-4;18
"198";"D";"Christian Backman";27;2,2;63;3;15;-2;18
"199";"D";"Christian Ehrhoff";25;0,9;77;1;21;9;22
"200";"D";"Christoph Schubert";25;0,85;82;8;16;7;24
"201";"RW";"Chuck Kobasew";25;1,2;73;22;17;6;39
"202";"LW";"D.J. King";23;0,5;61;3;3;-4;6
"203";"C";"Dainius Zubrus";29;3,4;82;13;25;2;38
"204";"LW";"Dallas Drake";38;0,55;65;3;3;-12;6
"205";"D";"Dan Boyle";31;3,62;37;4;21;-29;25
"206";"LW";"Dan Carcillo";22;0,64;57;13;11;1;24
"207";"G";"Dan Cloutier";31;1;9;0;0;0;0
"208";"G";"Dan Ellis";27;0,5;44;0;0;0;0
"209";"C";"Dan Fritsche";22;0,75;69;10;12;2;22
"210";"D";"Dan Girardi";23;0,75;82;10;18;0;28
"211";"D";"Dan Hamhuis";25;1,75;80;4;23;-4;27
"212";"RW";"Dan Hinote";30;1;58;5;5;-3;10
"213";"D";"Dan Jancevski";26;0,02;4;0;0;-1;0
"214";"G";"Dan LaCosta";21;0,04;1;0;0;0;0
"215";"G";"Dan Sabourin";27;0,5;24;0;0;0;0
"216";"G";"Dan Taylor";21;0,02;1;0;0;0;0
"217";"LW";"Dane Byers";21;0,01;1;0;0;-1;0
"218";"RW";"Daniel Alfredsson";35;4,69;70;40;49;15;89
"219";"C";"Daniel Briere";30;10;79;31;41;-22;72
"220";"LW";"Daniel Cleary";29;0,68;63;20;22;21;42
"221";"LW";"Daniel Paille";23;0,59;77;19;16;9;35
"222";"LW";"Daniel Sedin";27;3,58;82;29;45;6;74
"223";"LW";"Daniel Winnik";22;0,52;79;11;15;-3;26
"224";"D";"Danny Richmond";23;0,15;7;0;0;-5;0
"225";"RW";"Dany Heatley";26;5,5;71;41;41;33;82
"226";"LW";"Darcy Hordichuk";27;0,52;45;1;2;-1;3
"227";"LW";"Darcy Tucker";32;3;74;18;16;-8;34
"228";"RW";"Darren Haydar";28;0,16;16;1;7;4;8
"229";"C";"Darren Helm";20;0,09;7;0;0;-2;0
"230";"RW";"Darren McCarty";35;0,12;3;0;1;2;1
"231";"RW";"Darryl Bootland";26;0,07;4;0;1;0;1
"232";"C";"Darryl Boyce";23;0,21;1;0;0;0;0
"233";"D";"Darryl Sydor";35;2,5;74;1;12;1;13
"234";"C";"Dave Bolland";21;0,61;39;4;13;6;17
"235";"C";"Dave Steckel";25;0,52;67;5;7;1;12
"236";"G";"David Aebischer";29;0,07;1;0;0;0;0
"237";"RW";"David Backes";23;0,89;72;13;18;-11;31
"238";"LW";"David Booth";23;0,7;73;22;18;13;40
"239";"C";"David Brine";22;0,05;9;0;1;-1;1
"240";"RW";"David Clarkson";23;0,8;81;9;13;1;22
"241";"D";"David Hale";26;0,59;58;0;2;0;2
"242";"RW";"David Jones";23;0,17;27;2;4;-5;6
"243";"D";"David Koci";26;0,33;18;0;0;-4;0
"244";"C";"David Krejci";21;0,62;56;6;21;-3;27
"245";"C";"David Legwand";27;2,1;65;15;29;-4;44
"246";"RW";"David Moss";26;0,52;41;4;7;-4;11
"247";"C";"David Perron";19;0,92;62;13;14;16;27
"248";"D";"David Tanabe";27;0,59;18;1;2;2;3
"249";"RW";"David Vyborny";32;2,2;66;7;19;-8;26
"250";"C";"Daymond Langkow";31;2,44;80;30;35;16;65
"251";"LW";"Dean McAmmond";34;0,85;68;9;13;1;22
"252";"D";"Denis Grebeshkov";24;0,95;71;3;15;2;18
"253";"LW";"Denis Tolpeko";22;0,33;26;1;5;-4;6
"254";"D";"Dennis Seidenberg";26;0,85;47;0;15;6;15
"255";"D";"Dennis Wideman";24;0,6;81;13;23;11;36
"256";"C";"Derek Armstrong";34;1,4;77;8;27;4;35
"257";"LW";"Derek Boogaard";25;0,75;34;0;0;-5;0
"258";"C";"Derek MacKenzie";26;0,11;17;2;0;-2;2
"259";"D";"Derek Meech";23;0,45;32;0;3;-5;3
"260";"D";"Derek Morris";29;3,9;82;8;17;8;25
"261";"C";"Derek Roy";24;3;78;32;49;13;81
"262";"D";"Derian Hatcher";35;3,5;44;2;5;4;7
"263";"C";"Derick Brassard";20;0,31;17;1;1;-4;2
"264";"RW";"Devin Setoguchi";21;0,83;44;11;6;6;17
"265";"D";"Dick Tarnstrom";32;2;48;3;11;-11;14
"266";"D";"Dion Phaneuf";22;0,94;82;17;43;12;60
"267";"D";"Dmitri Kalinin";27;2,25;46;1;7;-7;8
"268";"G";"Dmitri Patzold";24;0,28;3;0;0;0;0
"269";"C";"Dominic Moore";27;0,7;68;5;12;-4;17
"270";"G";"Dominik Hasek";42;4,05;41;0;1;0;1
"271";"LW";"Donald Brashear";35;1,1;80;5;3;-7;8
"272";"D";"Doug Janik";27;0,48;61;1;3;-3;4
"273";"D";"Doug Murray";27;0,55;66;1;9;20;10
"274";"C";"Doug Weight";36;3,5;67;10;15;4;25
"275";"D";"Drew Fata";24;0,01;5;0;1;-1;1
"276";"C";"Drew Larman";22;0,03;6;0;1;1;1
"277";"G";"Drew MacIntyre";24;0,02;2;0;0;0;0
"278";"LW";"Drew Miller";23;0,34;26;2;3;-1;5
"279";"RW";"Drew Stafford";22;0,98;64;16;22;3;38
"280";"D";"Duncan Keith";24;1,4;82;12;20;30;32
"281";"C";"Dustin Boyd";21;0,54;48;7;5;-11;12
"282";"RW";"Dustin Brown";23;1,18;78;33;27;-13;60
"283";"D";"Dustin Byfuglien";22;0,54;67;19;17;-7;36
"284";"RW";"Dustin Penner";25;4,25;82;23;24;-12;47
"285";"D";"Duvie Westcott";30;0,93;23;1;3;-10;4
"286";"G";"Dwayne Roloson";38;3,5;43;0;1;0;1
"287";"D";"Ed Jovanovski";31;7;80;12;39;-13;51
"288";"RW";"Enver Lisin";21;0,18;13;4;1;-5;5
"289";"C";"Eric Belanger";30;1,75;75;13;24;-6;37
"290";"LW";"Eric Boulton";31;0,52;74;4;5;-10;9
"291";"D";"Eric Brewer";28;3,5;77;1;21;-18;22
"292";"RW";"Eric Fehr";22;0,76;23;1;5;4;6
"293";"RW";"Eric Godard";27;0,47;74;1;1;-8;2
"294";"LW";"Eric Nystrom";24;0,48;44;3;7;-5;10
"295";"C";"Eric Perrin";32;0,75;81;12;33;-5;45
"296";"C";"Eric Staal";23;4,5;82;38;44;-2;82
"297";"LW";"Erik Cole";29;4;73;22;29;5;51
"298";"C";"Erik Christensen";24;0,75;59;11;13;-10;24
"299";"G";"Erik Ersberg";25;0,18;14;0;0;0;0
"300";"D";"Erik Johnson";19;3,7;69;5;28;-9;33
"301";"LW";"Ethan Moreau";32;2,75;25;5;4;-4;9
"302";"C";"Evgeni Malkin";21;3,83;82;47;59;16;106
"303";"G";"Evgeni Nabokov";32;5;77;0;2;0;2
"304";"D";"Fedor Tyutin";24;1,02;82;5;15;5;20
"305";"RW";"Fernando Pisani";31;2,5;56;13;9;-5;22
"306";"D";"Filip Kuba";31;3;75;6;25;-8;31
"307";"D";"Francis Bouillon";32;1,88;74;2;6;9;8
"308";"D";"Francois Beauchemin";27;1,65;82;2;19;-9;21
"309";"C";"Frans Nielsen";23;0,2;16;2;1;1;3
"310";"D";"Frantisek Kaberle";34;2,2;80;0;22;-4;22
"311";"D";"Freddy Meyer";26;0,52;57;3;9;2;12
"312";"LW";"Fredrik Modin";33;2,75;23;6;6;1;12
"313";"G";"Fredrik Norrena";34;0,8;37;0;1;0;1
"314";"RW";"Fredrik Sjostrom";24;0,8;69;12;9;-2;21
"315";"C";"Gabe Gauthier";23;0,03;3;0;0;0;0
"316";"D";"Garnet Exelby";26;1,05;79;2;5;-21;7
"317";"D";"Garrett Stafford";27;0,01;2;0;0;0;0
"318";"C";"Garth Murray";25;0,58;7;0;0;0;0
"319";"LW";"Gary Roberts";41;2,5;38;3;12;-3;15
"320";"C";"Geoff Platt";22;0;5;0;0;2;0
"321";"LW";"Geoff Sanderson";35;1,5;41;3;10;-7;13
"322";"RW";"George Parros";28;0,52;69;1;4;3;5
"323";"RW";"Georges Laraque";31;1,25;71;4;9;0;13
"324";"C";"Gilbert Brule";21;1,06;61;1;8;-4;9
"325";"C";"Glen Metropolit";33;0,5;82;11;22;-3;33
"326";"RW";"Glen Murray";35;4,15;63;17;13;-4;30
"327";"D";"Glen Wesley";39;1,4;78;1;7;-3;8
"328";"LW";"Greg Campbell";24;0,52;81;5;13;-12;18
"329";"D";"Greg De Vries";34;2,25;77;4;11;7;15
"330";"C";"Greg Moore";23;0,09;6;0;0;-2;0
"331";"LW";"Greg Stewart";21;0,01;1;0;0;0;0
"332";"D";"Greg Zanon";27;0,7;78;0;5;-5;5
"333";"LW";"Guillaume Latendresse";20;0,85;73;16;11;-2;27
"334";"D";"Hal Gill";32;2,08;81;3;21;6;24
"335";"G";"Hannu Toivonen";23;0,48;23;0;0;0;0
"336";"G";"Henrik Lundqvist";25;4,25;72;0;0;0;0
"337";"C";"Henrik Sedin";27;3,58;82;15;61;6;76
"338";"D";"Henrik Tallinder";28;2,5;71;1;17;5;18
"339";"C";"Henrik Zetterberg";27;2,7;75;43;49;30;92
"340";"C";"Ian Laperriere";33;1,06;70;4;15;-5;19
"341";"D";"Ian White";23;0,75;81;5;16;-9;21
"342";"G";"Ilya Bryzgalov";27;1,36;64;0;0;0;0
"343";"LW";"Ilya Kovalchuk";24;5,43;79;52;35;-12;87
"344";"C";"Ilya Zubov";20;0;1;0;0;0;0
"345";"D";"Ivan Baranka";22;0,01;1;0;1;1;1
"346";"RW";"J.P. Dumont";29;2,5;80;29;43;5;72
"347";"D";"Jack Hillen";21;NA;2;0;1;1;1
"348";"D";"Jack Johnson";20;2,15;74;3;8;-19;11
"349";"LW";"Jack Skille";20;0,3;16;3;2;1;5
"350";"C";"Jake Dowell";22;0,25;19;2;1;1;3
"351";"RW";"Jamal Mayers";33;1,2;80;12;15;-19;27
"352";"C";"James Sheppard";19;1,4;78;4;15;0;19
"353";"D";"James Wisniewski";23;0,65;68;7;19;12;26
"354";"RW";"Jamie Langenbrunner";32;2,8;64;13;28;-1;41
"355";"D";"Jan Hejda";29;1;81;0;13;20;13
"356";"LW";"Jan Hlavac";31;0,7;80;12;23;-1;35
"357";"LW";"Jannik Hansen";21;0,05;5;0;0;0;0
"358";"RW";"Jared Boll";21;0,74;75;5;5;-4;10
"359";"LW";"Jarkko Ruutu";32;1,15;71;6;10;3;16
"360";"RW";"Jarome Iginla";30;7;82;50;48;27;98
"361";"RW";"Jaromir Jagr";35;8,36;82;25;46;8;71
"362";"G";"Jaroslav Halak";22;0,21;6;0;0;0;0
"363";"C";"Jaroslav Hlinka";31;0,6;63;8;20;6;28
"364";"D";"Jaroslav Modry";36;1,2;80;1;8;-9;9
"365";"D";"Jaroslav Spacek";33;3,48;60;9;23;7;32
"366";"C";"Jarret Stoll";25;2,2;81;14;22;-23;36
"367";"C";"Jason Arnott";33;4,5;79;28;44;19;72
"368";"LW";"Jason Blake";34;5;82;15;37;-4;52
"369";"LW";"Jason Chimera";28;1;81;14;17;-5;31
"370";"LW";"Jason Jaffray";26;0,12;19;2;4;4;6
"371";"LW";"Jason King";26;0,03;4;0;0;-3;0
"372";"G";"Jason Labarbera";27;0,8;45;0;0;0;0
"373";"RW";"Jason Pominville";25;0,92;82;27;53;16;80
"374";"D";"Jason Smith";34;1,98;77;1;9;-4;10
"375";"C";"Jason Spezza";24;5;76;34;58;26;92
"376";"D";"Jason Strudwick";32;0,5;52;1;1;0;2
"377";"RW";"Jason Ward";28;0,65;79;8;6;-18;14
"378";"C";"Jason Williams";27;1,6;43;13;23;-2;36
"379";"D";"Jassen Cullimore";35;0,47;65;3;10;21;13
"380";"D";"Jay Bouwmeester";24;2,25;82;15;22;-5;37
"381";"D";"Jay Leach";28;0,01;2;0;0;-1;0
"382";"C";"Jay McClement";24;0,7;81;9;13;-17;22
"383";"D";"Jay McKee";30;4;66;2;7;2;9
"384";"LW";"Jay Pandolfo";33;0,84;54;12;12;10;24
"385";"LW";"Jean-Francois Jacques";22;0,06;9;0;0;-3;0
"386";"G";"Jean-Sebastien Aubin";30;0,52;19;0;0;0;0
"387";"G";"Jean-Sebastien Giguere";30;5,5;58;0;0;0;0
"388";"RW";"Jed Ortmeyer";29;0,75;51;4;4;-8;8
"389";"C";"Jeff Carter";23;0,94;82;29;24;6;53
"390";"LW";"Jeff Cowan";31;0,72;46;0;1;-5;1
"391";"D";"Jeff Finger";28;0,48;72;8;11;12;19
"392";"LW";"Jeff Giuliano";28;0,3;53;0;6;-9;6
"393";"C";"Jeff Halpern";31;2;83;20;22;0;42
"394";"RW";"Jeff Hamilton";30;0,71;58;9;15;-8;24
"395";"LW";"Jeff Hoggan";29;0;1;0;0;0;0
"396";"D";"Jeff Schultz";21;0,78;72;5;13;12;18
"397";"C";"Jeff Taffe";26;0,29;45;5;7;2;12
"398";"LW";"Jeff Tambellini";23;0,33;31;1;3;-9;4
"399";"D";"Jeff Woywitka";24;0,21;27;2;6;2;8
"400";"LW";"Jere Lehtinen";34;3,9;48;15;22;9;37
"401";"C";"Jeremy Colliton";22;0,11;16;0;0;-4;0
"402";"LW";"Jeremy Reich";28;0,48;58;2;2;-5;4
"403";"C";"Jeremy Roenick";37;0,5;69;14;19;-8;33
"404";"RW";"Jeremy Williams";23;0,11;18;2;0;-3;2
"405";"C";"Jerred Smithson";28;0,48;81;7;9;-9;16
"406";"RW";"Jesse Boulerice";29;0,09;5;0;0;-2;0
"407";"C";"Jesse Winchester";24;NA;1;0;0;0;0
"408";"C";"Jim Dowd";39;0,5;73;5;5;0;10
"409";"C";"Jim Slater";25;0,75;69;8;5;-10;13
"410";"D";"Jim Vandermeer";27;1,23;75;3;14;6;17
"411";"G";"Jimmy Howard";23;0,14;4;0;0;0;0
"412";"LW";"Jiri Hudler";23;0,88;81;13;29;11;42
"413";"C";"Jiri Novotny";24;0,7;65;8;14;-10;22
"414";"LW";"Jiri Tlusty";19;0,69;58;10;6;-12;16
"415";"LW";"Joakim Lindstrom";24;0,2;25;3;4;0;7
"416";"G";"Jocelyn Thibault";32;0,76;12;0;0;0;0
"417";"C";"Jochen Hecht";30;2,35;75;22;27;1;49
"418";"LW";"Jody Shelley";31;0,65;62;1;6;-4;7
"419";"D";"Joe Corvo";30;2,5;74;13;35;17;48
"420";"D";"Joe DiPenta";28;0,7;23;1;4;3;5
"421";"F";"Joe Jensen";24;0,05;6;1;0;1;1
"422";"RW";"Joe Motzko";27;0,04;8;2;2;1;4
"423";"C";"Joe Pavelski";23;0,85;82;19;21;1;40
"424";"C";"Joe Sakic";38;6,75;44;13;27;-4;40
"425";"C";"Joe Thornton";28;6,67;82;29;67;18;96
"426";"D";"Joel Kwiatkowski";30;0,14;18;0;5;-5;5
"427";"C";"Joel Lundqvist";25;0,64;55;3;11;-3;14
"428";"C";"Joel Perrault";24;0,3;49;7;10;-11;17
"429";"G";"Joey MacDonald";27;0,04;2;0;0;0;0
"430";"D";"Joey Mormina";25;0;1;0;0;0;0
"431";"RW";"Joffrey Lupul";24;2,54;56;20;26;2;46
"432";"C";"Johan Franzen";28;0,9;72;27;11;12;38
"433";"G";"Johan Hedberg";34;1,15;36;0;1;0;1
"434";"G";"Johan Holmqvist";29;1;47;0;1;0;1
"435";"D";"John-Michael Liles";27;1,4;81;6;26;2;32
"436";"D";"John Erskine";27;0,52;51;2;7;1;9
"437";"G";"John Grahame";32;1,27;17;0;1;0;1
"438";"C";"John Madden";34;2,92;80;20;23;1;43
"439";"C";"John Pohl";28;0,48;33;1;4;-4;5
"440";"RW";"John Zeiler";25;0,36;36;0;1;-6;1
"441";"D";"Johnny Boychuk";23;0,07;4;0;0;1;0
"442";"D";"Johnny Oduya";26;0,6;75;6;20;27;26
"443";"LW";"Jon ""Bates"" Battaglia";32;0,27;13;0;0;-6;0
"444";"D";"Jon Klemm";37;0,19;22;0;0;-5;0
"445";"G";"Jon Quick";21;0,07;3;0;0;0;0
"446";"LW";"Jon Sim";30;1;2;0;1;-1;1
"447";"G";"Jonas Hiller";25;2,81;23;0;1;0;1
"448";"G";"Jonathan Bernier";19;0,06;4;0;0;0;0
"449";"RW";"Jonathan Cheechoo";27;2,5;69;23;14;11;37
"450";"D";"Jonathan Ericsson";23;0,05;8;1;0;-3;1
"451";"RW";"Jonathan Filewich";23;0,05;5;0;0;-2;0
"452";"C";"Jonathan Toews";19;2,8;64;24;30;11;54
"453";"D";"Joni Pitkanen";24;2,4;63;8;18;-5;26
"454";"D";"Jordan Hendry";23;0,22;40;1;3;0;4
"455";"LW";"Jordan LaVallee-Smotherman";21;0,01;2;1;1;2;2
"456";"D";"Jordan Leopold";27;1,5;43;5;8;5;13
"457";"C";"Jordan Staal";19;2,2;82;12;16;-5;28
"458";"RW";"Jordin Tootoo";24;0,7;63;11;7;-8;18
"459";"G";"Jose Theodore";31;6;53;0;2;0;2
"460";"C";"Josef Vasicek";27;0,75;81;16;19;1;35
"461";"D";"Josh Gorges";23;0,5;62;0;9;0;9
"462";"LW";"Josh Gratton";25;0,12;1;0;0;1;0
"463";"G";"Josh Harding";23;0,7;29;0;1;0;1
"464";"C";"Josh Hennessy";22;0,03;5;0;0;-1;0
"465";"RW";"Josh Langfeld";30;0,01;2;0;0;0;0
"466";"C";"Jozef Stumpel";35;2,25;52;7;13;-11;20
"467";"RW";"Junior Lessard";27;0,12;21;1;1;-6;2
"468";"C";"Jussi Jokinen";24;1,75;72;16;26;-14;42
"469";"LW";"Justin Abdelkader";20;NA;2;0;0;0;0
"470";"RW";"Justin Williams";26;3,5;37;9;21;2;30
"471";"C";"Kamil Kreps";23;0,46;76;8;17;10;25
"472";"D";"Karel Rachunek";28;1,4;47;4;9;3;13
"473";"G";"Kari Lehtonen";24;2,2;48;0;2;0;2
"474";"LW";"Karl Stewart";24;0,08;9;0;0;-2;0
"475";"D";"Karlis Skrastins";33;2,4;60;2;3;-11;5
"476";"G";"Karri Ramo";21;0,39;22;0;1;0;1
"477";"C";"Keith Aucoin";29;0,22;38;5;8;3;13
"478";"D";"Keith Ballard";25;2,05;82;6;15;7;21
"479";"D";"Keith Carney";37;2,1;61;1;10;8;11
"480";"LW";"Keith Tkachuk";35;3,5;79;27;31;-2;58
"481";"D";"Keith Yandle";21;0,53;43;5;7;-12;12
"482";"D";"Ken Klee";36;1,25;72;1;9;-5;10
"483";"D";"Kent Huskins";28;0,6;76;4;15;23;19
"484";"D";"Kevin Bieksa";26;0,55;34;2;10;-11;12
"485";"D";"Kevin Dallman";26;0,49;34;3;4;4;7
"486";"C";"Kevin Doell";28;0,05;8;0;1;-2;1
"487";"D";"Kevin Klein";23;0,5;13;0;2;-3;2
"488";"G";"Kevin Weekes";32;0,68;9;0;0;0;0
"489";"C";"Kevyn Adams";33;0,65;27;0;2;-7;2
"490";"D";"Kim Johnsson";31;4,8;80;4;23;-4;27
"491";"D";"Kimmo Timonen";32;8;80;8;36;0;44
"492";"LW";"Kip Brennan";27;0,01;3;0;0;0;0
"493";"LW";"Kirk Maltby";35;0,95;61;6;4;-8;10
"494";"C";"Kris Beech";26;0,46;25;6;5;3;11
"495";"C";"Kris Draper";36;2,13;65;9;8;-2;17
"496";"D";"Kris Letang";20;0,65;63;6;11;-1;17
"497";"C";"Kris Newbury";25;0,17;28;1;1;-7;2
"498";"D";"Kris Russell";20;0,75;67;2;8;-12;10
"499";"LW";"Kris Versteeg";21;0,1;13;2;2;-1;4
"500";"LW";"Kristian Huselius";29;1,4;81;25;41;10;66
"501";"RW";"Krys Barch";27;0,48;48;1;2;-3;3
"502";"D";"Kurt Sauer";26;0,72;54;1;5;17;6
"503";"D";"Kurtis Foster";26;1,02;56;7;12;0;19
"504";"C";"Kyle Brodziak";23;0,5;80;14;17;-6;31
"505";"LW";"Kyle Calder";28;2,7;65;7;13;-11;20
"506";"D";"Kyle Cumiskey";21;0,5;38;0;5;-3;5
"507";"C";"Kyle Chipchura";21;0,49;36;4;7;-1;11
"508";"LW";"Kyle Greentree";24;0,02;2;0;0;-1;0
"509";"D";"Kyle McLaren";30;2,5;61;3;8;3;11
"510";"RW";"Kyle Okposo";19;0,17;9;2;3;3;5
"511";"D";"Kyle Quincey";22;0,1;6;0;0;-3;0
"512";"C";"Kyle Turris";18;0,09;3;0;1;-5;1
"513";"RW";"Kyle Wanvig";26;0,06;7;1;0;-1;1
"514";"C";"Kyle Wellwood";24;0,95;59;8;13;-12;21
"515";"LW";"Ladislav Nagy";28;3,75;38;9;17;-2;26
"516";"D";"Ladislav Smid";21;0,62;65;0;4;-15;4
"517";"D";"Lasse Kukkonen";26;0,85;53;1;4;3;5
"518";"RW";"Lauri Tukonen";21;0,02;1;0;0;0;0
"519";"D";"Lawrence Nycholat";28;0,02;3;0;0;1;0
"520";"RW";"Lee Stempniak";24;1,5;80;13;25;0;38
"521";"LW";"Liam Reddox";21;0,02;1;0;0;-1;0
"522";"LW";"Loui Eriksson";22;0,7;69;14;17;5;31
"523";"D";"Lubomir Visnovsky";31;2,05;82;8;33;-18;41
"524";"D";"Luc Bourdon";20;0,58;27;2;0;7;2
"525";"LW";"Lukas Kaspar";22;0,06;3;0;0;-2;0
"526";"D";"Lukas Krajicek";24;1,1;39;2;9;-3;11
"527";"D";"Luke Richardson";38;0,5;76;2;7;1;9
"528";"D";"Magnus Johansson";34;0,7;45;0;14;-5;14
"529";"G";"Manny Fernandez";33;4,5;4;0;0;0;0
"530";"G";"Manny Legace";34;1,8;66;0;2;0;2
"531";"C";"Manny Malhotra";27;1,2;71;11;18;-2;29
"532";"D";"Marc-Andre Bergeron";27;1,2;55;9;10;-16;19
"533";"G";"Marc-Andre Fleury";23;1,6;35;0;1;0;1
"534";"D";"Marc-Andre Gragnani";20;0,02;2;0;0;-2;0
"535";"D";"Marc-Edouard Vlasic";20;1,08;82;2;12;-12;14
"536";"G";"Marc Denis";30;1,38;10;0;0;0;0
"537";"D";"Marc Methot";22;0,13;9;0;0;-1;0
"538";"C";"Marc Pouliot";22;0,32;24;1;6;-1;7
"539";"C";"Marc Savard";30;5;74;15;63;3;78
"540";"D";"Marc Staal";20;0,85;80;2;8;2;10
"541";"C";"Marcel Goc";24;0,8;51;5;3;-15;8
"542";"LW";"Marcel Hossa";26;0,78;50;1;7;2;8
"543";"LW";"Marco Sturm";29;3,5;80;27;29;11;56
"544";"C";"Marcus Nilson";29;1;47;3;2;2;5
"545";"D";"Marek Malik";32;2,5;42;2;8;7;10
"546";"G";"Marek Schwarz";21;0,1;2;0;0;0;0
"547";"RW";"Marek Svatos";25;1,2;62;26;11;13;37
"548";"D";"Marek Zidlicky";30;3,2;79;5;38;-5;43
"549";"RW";"Marian Gaborik";25;6,5;77;42;41;17;83
"550";"RW";"Marian Hossa";28;7;72;29;37;-14;66
"551";"LW";"Mark Bell";27;2;35;4;6;-2;10
"552";"D";"Mark Eaton";30;1,6;36;0;3;6;3
"553";"D";"Mark Fistric";21;0,44;37;0;2;3;2
"554";"C";"Mark Hartigan";30;0,17;23;3;1;-2;4
"555";"RW";"Mark Mowers";33;0,14;17;1;0;0;1
"556";"RW";"Mark Parrish";30;2,65;66;16;14;2;30
"557";"D";"Mark Popovic";25;0,54;33;0;2;-4;2
"558";"RW";"Mark Recchi";39;1,75;72;14;34;-18;48
"559";"C";"Mark Smith";30;0,49;54;1;3;-6;4
"560";"D";"Mark Streit";30;0,6;81;13;49;-6;62
"561";"D";"Mark Stuart";23;1,58;82;4;4;2;8
"562";"LW";"Markus Naslund";34;6;82;25;30;-7;55
"563";"G";"Martin Biron";30;3,5;62;0;1;0;1
"564";"G";"Martin Brodeur";35;5,2;77;0;4;0;4
"565";"LW";"Martin Erat";26;1,75;76;23;34;-3;57
"566";"LW";"Martin Gelinas";37;1,25;57;9;11;5;20
"567";"G";"Martin Gerber";33;3,7;57;0;2;0;2
"568";"LW";"Martin Hanzal";20;0,98;72;8;27;-7;35
"569";"LW";"Martin Havlat";26;6;35;10;17;4;27
"570";"RW";"Martin Lapointe";34;2,4;70;6;7;-5;13
"571";"D";"Martin Lojek";22;0,02;2;0;0;-1;0
"572";"LW";"Martin Rucinsky";36;3;40;5;11;-9;16
"573";"D";"Martin Skoula";28;1,7;80;3;8;-16;11
"574";"RW";"Martin St. Louis";32;6;82;25;58;-23;83
"575";"C";"Martin St. Pierre";24;0,04;5;0;0;-3;0
"576";"C";"Martin Straka";35;3,3;65;14;27;5;41
"577";"C";"Marty Reasoner";30;0,95;82;11;14;-17;25
"578";"G";"Marty Turco";32;5,7;62;0;3;0;3
"579";"LW";"Mason Raymond";22;0,66;49;9;12;1;21
"580";"LW";"Mathias Tjarnqvist";28;0,48;78;4;7;-1;11
"581";"D";"Mathieu Dandenault";31;1,75;61;9;5;-11;14
"582";"LW";"Mathieu Darche";31;0,46;73;7;15;-14;22
"583";"G";"Mathieu Garon";29;1,2;47;0;0;0;0
"584";"D";"Mathieu Roy";24;0,33;13;0;1;0;1
"585";"D";"Mathieu Schneider";38;5,5;65;12;27;22;39
"586";"C";"Mats Sundin";36;5,5;74;32;46;17;78
"587";"RW";"Matt Bradley";29;0,7;77;7;11;1;18
"588";"D";"Matt Carle";23;1,37;62;2;13;-8;15
"589";"LW";"Matt Cooke";29;1,52;78;10;13;1;23
"590";"C";"Matt Cullen";31;2,8;59;13;36;2;49
"591";"RW";"Matt D'Agostini";21;0;1;0;0;0;0
"592";"C";"Matt Ellis";26;0,48;54;3;5;3;8
"593";"RW";"Matt Foy";24;0,51;28;4;4;-1;8
"594";"D";"Matt Greene";24;1,05;46;0;1;-3;1
"595";"D";"Matt Hunwick";22;0,17;13;0;1;-1;1
"596";"D";"Matt Jones";24;0,52;45;0;2;-13;2
"597";"G";"Matt Keetley";21;0,1;1;0;0;0;0
"598";"RW";"Matt Keith";24;0,01;3;0;0;-1;0
"599";"D";"Matt Lashoff";21;0,19;18;1;4;-2;5
"600";"LW";"Matt Moulson";24;0,12;22;5;4;2;9
"601";"C";"Matt Murley";28;0,03;3;0;1;1;1
"602";"D";"Matt Niskanen";21;0,85;78;7;19;22;26
"603";"LW";"Matt Pettinger";27;1;76;6;7;-11;13
"604";"D";"Matt Smaby";23;0,24;14;0;0;-6;0
"605";"C";"Matt Stajan";24;0,95;82;16;17;-11;33
"606";"D";"Matt Walker";27;0,6;43;1;1;-3;2
"607";"C";"Matthew Lombardi";25;1,55;82;14;22;-6;36
"608";"D";"Matthew Spiller";24;0,02;9;0;1;-2;1
"609";"D";"Mattias Norstrom";35;4,25;66;2;11;3;13
"610";"D";"Mattias Ohlund";31;3,38;53;9;15;-1;24
"611";"C";"Mattias Ritola";20;0;2;0;1;0;1
"612";"C";"Max Talbot";23;0,65;63;12;14;8;26
"613";"RW";"Maxim Afinogenov";28;3,5;56;10;18;-16;28
"614";"D";"Maxim Kondratiev";24;0,1;4;0;0;-2;0
"615";"C";"Maxim Lapierre";22;0,39;53;7;11;5;18
"616";"D";"Micki DuPont";27;0,02;2;0;0;1;0
"617";"G";"Michael Leighton";26;0,05;3;0;0;0;0
"618";"C";"Michael Nylander";35;5,5;40;11;26;-19;37
"619";"C";"Michael Peca";33;1,92;65;8;26;-1;34
"620";"C";"Michael Ryan";27;0,48;46;4;4;-4;8
"621";"RW";"Michael Ryder";27;2,95;70;14;17;-4;31
"622";"C";"Michal Handzus";30;4;82;7;14;-21;21
"623";"D";"Michal Rozsival";29;2,3;80;13;25;0;38
"624";"LW";"Michel Ouellet";25;1,2;64;17;19;11;36
"625";"G";"Miikka Kiprusoff";31;3,6;76;0;2;0;2
"626";"RW";"Mikael Samuelsson";31;1,2;73;11;29;21;40
"627";"G";"Mikael Tellqvist";28;0,8;22;0;1;0;1
"628";"RW";"Mike Blunden";21;0,02;1;0;0;-1;0
"629";"RW";"Mike Brown";22;0,17;19;1;0;-2;1
"630";"C";"Mike Cammalleri";25;3,1;63;19;28;-16;47
"631";"D";"Mike Commodore";28;1,3;67;3;11;-7;14
"632";"C";"Mike Comrie";27;3,38;76;21;28;-21;49
"633";"C";"Mike Fisher";27;1,5;79;23;24;-10;47
"634";"D";"Mike Funk";21;0,03;4;0;0;-3;0
"635";"RW";"Mike Glumac";27;0,02;4;0;0;-1;0
"636";"D";"Mike Green";22;0,85;82;18;38;6;56
"637";"RW";"Mike Grier";32;1,77;78;9;13;-8;22
"638";"C";"Mike Iggulden";25;0;1;0;0;-1;0
"639";"RW";"Mike Johnson";33;0,75;21;2;3;-4;5
"640";"RW";"Mike Knuble";35;2,8;82;29;26;-3;55
"641";"D";"Mike Komisarek";25;1,5;75;4;13;9;17
"642";"D";"Mike Lundin";23;0,64;81;0;6;3;6
"643";"C";"Mike Modano";37;4,25;82;21;36;-11;57
"644";"D";"Mike Mottau";29;0,48;76;4;13;-11;17
"645";"C";"Mike Ribeiro";27;2,8;76;27;56;21;83
"646";"C";"Mike Richards";22;0,94;73;28;47;14;75
"647";"RW";"Mike Rupp";27;0,5;64;3;6;-8;9
"648";"C";"Mike Sillinger";36;2,2;52;14;12;-10;26
"649";"G";"Mike Smith";25;0,95;34;0;1;0;1
"650";"D";"Mike Van Ryn";28;3,2;20;0;2;-2;2
"651";"D";"Mike Weaver";29;0,6;55;0;1;1;1
"652";"D";"Mike Weber";20;0,13;16;0;3;12;3
"653";"LW";"Mike York";29;1;63;6;8;-8;14
"654";"C";"Mike Zigomanis";26;0,44;33;2;1;-7;3
"655";"C";"Mikhail Grabovski";23;0,4;24;3;6;-4;9
"656";"C";"Mikko Koivu";24;2,7;57;11;31;13;42
"657";"RW";"Milan Hejduk";31;4;77;29;25;8;54
"658";"D";"Milan Jurcina";24;0,85;75;1;8;4;9
"659";"LW";"Milan Lucic";19;0,85;77;8;19;-2;27
"660";"LW";"Milan Michalek";23;0,94;79;24;31;19;55
"661";"RW";"Miroslav Satan";33;4,5;80;16;25;-11;41
"662";"D";"Nate Guenin";25;0,05;2;0;0;2;0
"663";"C";"Nathan Horton";22;3;82;27;35;15;62
"664";"D";"Nathan McIver";22;0,15;17;0;0;-8;0
"665";"D";"Nathan Paetsch";24;0,7;59;2;7;3;9
"666";"C";"Nathan Smith";25;0,08;13;0;0;0;0
"667";"D";"Nick Boynton";28;2,9;79;3;9;-9;12
"668";"LW";"Nick Foligno";20;0,56;45;6;3;0;9
"669";"D";"Nick Schultz";25;1,85;81;2;13;9;15
"670";"C";"Nick Tarnasky";23;0,5;80;6;4;-15;10
"671";"C";"Nicklas Backstrom";20;2,4;82;14;55;13;69
"672";"RW";"Nicklas Bergfors";20;0,06;1;0;0;-1;0
"673";"D";"Nicklas Lidstrom";37;7,6;76;10;60;40;70
"674";"D";"Niclas Havelid";34;2,7;81;1;13;2;14
"675";"D";"Niclas Wallin";32;1,73;66;2;6;-18;8
"676";"LW";"Nigel Dawes";22;0,36;61;14;15;11;29
"677";"C";"Nik Antropov";27;1,87;72;26;30;10;56
"678";"G";"Niklas Backstrom";29;3,1;58;0;0;0;0
"679";"D";"Niklas Grossman";22;0,51;62;0;7;10;7
"680";"LW";"Niklas Hagman";28;0,68;82;27;14;4;41
"681";"D";"Niklas Hjalmarsson";20;0,13;13;0;1;-2;1
"682";"D";"Niklas Kronwall";26;1,5;65;7;28;25;35
"683";"C";"Niko Kapanen";29;0,9;79;10;18;-1;28
"684";"G";"Nikolai Khabibulin";34;6,75;50;0;2;0;2
"685";"LW";"Nikolai Zherdev";23;2,5;82;26;35;-9;61
"686";"LW";"Noah Clarke";28;0,01;1;1;0;0;1
"687";"D";"Noah Welch";25;0,55;4;0;0;1;0
"688";"D";"Nolan Pratt";32;0,46;55;1;6;1;7
"689";"G";"Olaf Kolzig";37;5,45;54;0;2;0;2
"690";"D";"Ole-Kristian Tollefsen";23;0,6;51;2;2;-3;4
"691";"C";"Olli Jokinen";29;5,25;82;34;37;-19;71
"692";"D";"Olli Malmivaara";25;0,01;2;0;0;2;0
"693";"G";"Ondrej Pavelec";20;0,33;7;0;0;0;0
"694";"RW";"Owen Nolan";35;1,75;77;16;16;6;32
"695";"LW";"P.J. Axelsson";32;1,85;75;13;16;11;29
"696";"LW";"Pascal Dupuis";28;0,88;78;12;15;0;27
"697";"G";"Pascal Leclaire";25;1,4;54;0;2;0;2
"698";"C";"Pascal Pelletier";24;0,04;6;0;0;-2;0
"699";"LW";"Pat Rissmiller";29;0,6;79;8;9;-8;17
"700";"C";"Patrice Bergeron";22;5;10;3;4;2;7
"701";"D";"Patrice Brisebois";36;1,4;43;3;8;-2;11
"702";"RW";"Patrick Eaves";23;0,94;37;5;10;-2;15
"703";"RW";"Patrick Kaleta";21;0,22;40;3;2;1;5
"704";"RW";"Patrick Kane";19;3,73;82;21;51;-5;72
"705";"G";"Patrick Lalime";33;0,95;32;0;0;0;0
"706";"LW";"Patrick Marleau";28;4,5;78;19;29;-19;48
"707";"LW";"Patrick O'Sullivan";22;0,85;82;22;31;-8;53
"708";"C";"Patrick Sharp";26;0,82;80;36;26;23;62
"709";"LW";"Patrick Thoresen";24;0,39;38;2;6;-10;8
"710";"C";"Patrik Elias";31;7,5;74;20;35;10;55
"711";"C";"Paul Gaustad";25;0,75;82;10;26;-4;36
"712";"LW";"Paul Kariya";33;6;82;16;49;-10;65
"713";"D";"Paul Mara";28;3;61;1;16;1;17
"714";"D";"Paul Martin";26;3;73;5;27;20;32
"715";"D";"Paul Ranger";23;0,75;72;10;21;-13;31
"716";"C";"Paul Stastny";22;0,85;66;24;47;22;71
"717";"C";"Pavel Datsyuk";29;6,7;82;31;66;41;97
"718";"D";"Pavel Kubina";30;5;72;11;29;5;40
"719";"C";"Pavol Demitra";33;4,5;68;15;39;9;54
"720";"G";"Pekka Rinne";25;0,04;1;0;0;0;0
"721";"G";"Peter Budaj";25;0,7;35;0;1;0;1
"722";"C";"Peter Forsberg";34;1,12;9;1;13;7;14
"723";"D";"Peter Harrold";24;0,16;25;2;3;3;5
"724";"C";"Peter Mueller";19;1,7;81;22;32;-13;54
"725";"LW";"Peter Schaefer";30;2,1;63;9;17;4;26
"726";"LW";"Peter Vandermeer";32;0,02;2;0;0;0;0
"727";"RW";"Petr Prucha";25;1,6;62;7;10;3;17
"728";"RW";"Petr Sykora";31;2,5;81;28;35;1;63
"729";"C";"Petri Kontiola";23;0,11;12;0;5;5;5
"730";"C";"Petteri Nokelainen";21;0,87;57;7;3;0;10
"731";"D";"Petteri Nummelin";35;1,2;27;2;7;-2;9
"732";"C";"Petteri Wirtanen";21;0,03;3;1;0;1;1
"733";"RW";"Phil Kessel";20;2,2;82;19;18;-6;37
"734";"D";"Philippe Boucher";34;2,5;38;2;12;3;14
"735";"C";"Pierre-Marc Bouchard";23;2,6;81;13;50;11;63
"736";"LW";"Quintin Laing";28;0,33;39;1;5;4;6
"737";"C";"R.J. Umberger";25;1,25;74;13;37;0;50
"738";"C";"Radek Bonk";31;1,35;79;14;15;-31;29
"739";"RW";"Radek Dvorak";30;1,5;67;8;9;-1;17
"740";"D";"Radek Martinek";31;0,7;69;0;15;-9;15
"741";"RW";"Radim Vrbata";26;1,23;76;27;29;6;56
"742";"LW";"Raffi Torres";26;1,6;32;5;6;-4;11
"743";"LW";"Raitis Ivanans";28;0,48;73;6;2;-10;8
"744";"D";"Randy Jones";26;0,51;71;5;26;8;31
"745";"C";"Randy Robitaille";32;0,58;68;10;19;4;29
"746";"G";"Ray Emery";25;2,75;31;0;0;0;0
"747";"LW";"Ray Whitney";35;3,55;66;25;36;-6;61
"748";"LW";"Rene Bourque";26;0,9;62;10;14;6;24
"749";"D";"Rhett Warrener";31;2,5;31;1;3;-2;4
"750";"G";"Rick DiPietro";26;4,5;63;0;6;0;6
"751";"RW";"Rick Nash";23;5,5;80;38;31;3;69
"752";"C";"Rick Rypien";23;0,24;22;1;2;-5;3
"753";"C";"Rich Peverley";25;0,18;33;5;5;4;10
"754";"RW";"Richard Park";31;0,48;82;12;20;-4;32
"755";"LW";"Richard Zednik";31;1,5;54;15;11;-5;26
"756";"LW";"Riley Cote";25;0,48;70;1;3;2;4
"757";"D";"Rob Blake";38;6;71;9;22;-19;31
"758";"D";"Rob Davison";27;0,52;34;1;1;-6;2
"759";"RW";"Rob Globke";25;0,07;9;0;0;-3;0
"760";"C";"Rob Niedermayer";33;2;78;8;8;1;16
"761";"D";"Rob Scuderi";29;0,7;71;0;5;3;5
"762";"C";"Rob Schremp";21;0,02;2;0;0;-1;0
"763";"LW";"Robbie Earl";22;0,07;9;0;1;-2;1
"764";"C";"Robert Lang";37;4;76;21;33;9;54
"765";"RW";"Robert Nilsson";22;0,92;71;10;31;8;41
"766";"G";"Roberto Luongo";28;6,5;73;0;3;0;3
"767";"D";"Robyn Regehr";27;2,28;82;5;15;11;20
"768";"C";"Rod Brind'Amour";37;4;59;19;32;0;51
"769";"C";"Rod Pelley";23;0,46;58;2;4;-3;6
"770";"D";"Roman Hamrlik";33;5,5;77;5;21;7;26
"771";"D";"Roman Polak";21;0,06;6;0;1;1;1
"772";"D";"Ron Hainsey";26;0,9;78;8;24;-7;32
"773";"D";"Rory Fitzpatrick";32;0,41;19;0;1;-12;1
"774";"D";"Rostislav Klesla";25;1,45;82;6;12;7;18
"775";"C";"Rostislav Olesz";22;0,98;56;14;12;3;26
"776";"LW";"Ruslan Fedotenko";28;2,9;67;16;17;-9;33
"777";"D";"Ruslan Salei";33;3,02;82;6;24;-4;30
"778";"LW";"Ryan Bayda";27;0,2;31;3;3;-2;6
"779";"D";"Ryan Caldwell";26;0,01;2;0;0;0;0
"780";"RW";"Ryan Callahan";22;0,5;52;8;5;7;13
"781";"C";"Ryan Carter";24;0,57;34;4;4;-2;8
"782";"LW";"Ryan Craig";25;0,85;7;1;1;-1;2
"783";"C";"Ryan Getzlaf";22;0,74;77;24;58;32;82
"784";"LW";"Ryan Hollweg";24;0,5;70;2;2;-12;4
"785";"C";"Ryan Johnson";31;0,8;79;5;13;-2;18
"786";"C";"Ryan Kesler";23;1,75;80;21;16;1;37
"787";"LW";"Ryan Malone";28;1,45;77;27;24;14;51
"788";"G";"Ryan Miller";27;2,5;76;0;1;0;1
"789";"D";"Ryan O'Byrne";23;0,4;33;1;6;7;7
"790";"D";"Ryan Parent";20;0,25;22;0;0;-4;0
"791";"C";"Ryan Potulny";23;0,04;7;0;1;0;1
"792";"RW";"Ryan Shannon";24;0,19;27;5;8;-1;13
"793";"LW";"Ryan Smyth";31;7,5;55;14;23;-4;37
"794";"C";"Ryan Stone";22;0,14;6;0;1;-1;1
"795";"D";"Ryan Suter";22;0,94;76;7;24;3;31
"796";"D";"Ryan Whitney";24;2,5;76;12;28;-2;40
"797";"LW";"Ryane Clowe";25;0,6;15;3;5;-1;8
"798";"C";"Saku Koivu";33;4,75;77;16;40;-4;56
"799";"C";"Sam Gagner";18;1,62;79;13;36;-21;49
"800";"RW";"Sami Kapanen";34;1,25;74;5;3;-12;8
"801";"D";"Sami Lepisto";23;0,08;7;0;1;-1;1
"802";"D";"Sami Salo";33;3;63;8;17;8;25
"803";"C";"Samuel Pahlsson";30;1,4;56;6;9;-2;15
"804";"D";"Sandis Ozolinsh";35;0,52;39;3;13;-11;16
"805";"G";"Scott Clemmensen";30;0,04;3;0;0;0;0
"806";"C";"Scott Gomez";28;10;81;16;54;3;70
"807";"D";"Scott Hannan";28;4,5;82;2;19;-5;21
"808";"RW";"Scott Hartnell";25;5,09;80;24;19;2;43
"809";"C";"Scott Nichol";33;0,71;73;10;8;12;18
"810";"D";"Scott Niedermayer";34;4,12;48;8;17;-2;25
"811";"RW";"Scott Parker";29;0,48;25;0;0;0;0
"812";"LW";"Scott Thornton";36;1,5;47;5;3;1;8
"813";"RW";"Scott Walker";34;2,47;58;14;18;-3;32
"814";"LW";"Scottie Upshall";24;1,2;61;14;16;2;30
"815";"LW";"Sean Avery";27;1,9;57;15;18;6;33
"816";"LW";"Sean Bergenheim";23;0,5;78;10;12;-3;22
"817";"D";"Sean Hill";37;0,99;35;2;7;-16;9
"818";"D";"Sean O'Donnell";36;1,25;82;2;7;9;9
"819";"C";"Sergei Brylin";33;1,52;82;6;10;-5;16
"820";"C";"Sergei Fedorov";38;6,08;68;11;30;-5;41
"821";"D";"Sergei Gonchar";33;5,5;78;12;53;13;65
"822";"RW";"Sergei Kostitsyn";20;0,51;52;9;18;9;27
"823";"LW";"Sergei Samsonov";29;3,52;61;14;22;-1;36
"824";"D";"Sergei Zubov";37;4;46;4;31;6;35
"825";"RW";"Shane Doan";31;4,55;80;28;50;4;78
"826";"D";"Shane Hnidy";32;0,76;76;2;6;-2;8
"827";"D";"Shane O'Brien";24;0,88;77;4;17;-2;21
"828";"D";"Shaone Morrisonn";25;0,9;76;1;9;4;10
"829";"C";"Shawn Bates";32;1,2;2;0;0;-2;0
"830";"C";"Shawn Horcoff";29;3,6;53;21;29;1;50
"831";"C";"Shawn Matthias";19;0,03;4;2;0;-2;2
"832";"LW";"Shawn Thornton";30;0,5;58;4;3;-1;7
"833";"D";"Shea Weber";22;0,48;54;6;14;-6;20
"834";"RW";"Shean Donovan";32;0,92;82;5;7;-3;12
"835";"D";"Sheldon Brookbank";27;0,5;44;0;8;0;8
"836";"D";"Sheldon Souray";31;6,25;26;3;7;-7;10
"837";"C";"Sidney Crosby";20;3,7;53;24;48;18;72
"838";"LW";"Simon Gagne";27;5,25;25;7;11;-8;18
"839";"C";"Simon Gamache";26;0,07;11;2;2;-1;4
"840";"LW";"Slava Kozlov";35;3,3;82;17;24;-10;41
"841";"D";"Staffan Kronwall";24;0,11;18;0;0;-2;0
"842";"LW";"Stefan Meyer";22;0,04;4;0;0;-1;0
"843";"RW";"Stefan Ruzicka";22;0,1;14;1;3;5;4
"844";"D";"Stephane Robidas";30;1,5;82;9;17;0;26
"845";"LW";"Stephane Veilleux";26;0,6;77;11;7;-13;18
"846";"C";"Stephane Yelle";33;1,25;74;3;9;-4;12
"847";"G";"Stephen Wagner";30;NA;2;0;1;0;1
"848";"C";"Stephen Weiss";24;1,8;74;13;29;14;42
"849";"LW";"Steve Begin";29;1,23;44;3;5;0;8
"850";"RW";"Steve Bernier";22;1,18;76;16;16;-1;32
"851";"RW";"Steve Downie";20;0,45;32;6;6;2;12
"852";"D";"Steve Eminger";24;1;20;0;2;-4;2
"853";"C";"Steve Kelly";31;0,08;2;0;0;0;0
"854";"D";"Steve McCarthy";26;0,72;55;1;6;-23;7
"855";"D";"Steve Montador";28;0,8;73;8;15;1;23
"856";"LW";"Steve Ott";25;0,8;73;11;11;2;22
"857";"LW";"Steve Regier";23;0,02;8;0;0;-1;0
"858";"C";"Steve Reinprecht";31;2;81;16;30;-3;46
"859";"D";"Steve Staios";34;2,9;82;7;9;-14;16
"860";"G";"Steve Valiquette";30;0,64;13;0;0;0;0
"861";"D";"Steve Wagner";23;0,37;24;2;6;-4;8
"862";"C";"Stu Barnes";37;0,9;79;12;11;-3;23
"863";"C";"T.J. Hensick";22;0,32;31;6;5;-4;11
"864";"LW";"Tanner Glass";24;0,51;41;1;1;-5;2
"865";"LW";"Taylor Pyatt";26;1,57;79;16;21;9;37
"866";"LW";"Ted Purcell";22;0,15;10;1;2;2;3
"867";"RW";"Teemu Selanne";37;1,07;26;12;11;5;23
"868";"D";"Teppo Numminen";39;0,08;1;0;0;0;0
"869";"D";"Theo Peckham";20;0,01;1;0;0;0;0
"870";"G";"Thomas Greiss";21;0,17;3;0;0;0;0
"871";"D";"Thomas Pock";26;0,08;1;0;0;-2;0
"872";"LW";"Thomas Vanek";23;10;82;36;28;-5;64
"873";"C";"Tim Brent";23;0,01;1;0;0;-1;0
"874";"D";"Tim Conboy";25;0,16;19;0;5;1;5
"875";"C";"Tim Connolly";26;3;48;7;33;4;40
"876";"D";"Tim Gleason";24;1,18;80;3;16;5;19
"877";"RW";"Tim Jackman";26;0,18;36;1;3;-3;4
"878";"D";"Tim Ramholt";23;0,01;1;0;0;-1;0
"879";"G";"Tim Thomas";33;1;57;0;0;0;0
"880";"G";"Tobias Stephan";23;0,04;1;0;0;0;0
"881";"D";"Toby Enstrom";23;0,9;82;5;33;-5;38
"882";"C";"Toby Petersen";29;0,09;8;0;3;0;3
"883";"RW";"Todd Bertuzzi";32;4;68;14;26;8;40
"884";"LW";"Todd Fedoruk";28;0,88;69;6;7;2;13
"885";"C";"Todd Marchant";34;2,47;75;9;7;-3;16
"886";"C";"Todd White";32;2,1;74;14;23;-12;37
"887";"C";"Tom Cavanagh";25;0,01;1;0;1;1;1
"888";"D";"Tom Gilbert";24;0,91;82;13;20;-6;33
"889";"RW";"Tom Kostopoulos";28;0,9;67;7;6;-3;13
"890";"D";"Tom Poti";30;3,5;71;2;27;9;29
"891";"D";"Tom Preissing";29;2,75;77;8;16;-6;24
"892";"LW";"Tom Sestito";20;0;1;0;0;0;0
"893";"LW";"Tomas Fleischmann";23;0,5;75;10;20;-7;30
"894";"RW";"Tomas Holmstrom";34;2,25;59;20;20;9;40
"895";"D";"Tomas Kaberle";29;4,25;82;8;45;-8;53
"896";"C";"Tomas Kopecky";25;0,48;77;5;7;2;12
"897";"C";"Tomas Plekanec";25;1,4;81;29;40;15;69
"898";"C";"Tomas Plihal";24;0,35;22;2;1;4;3
"899";"G";"Tomas Vokoun";31;5,3;69;0;6;0;6
"900";"D";"Toni Lydman";30;2,9;82;4;22;1;26
"901";"C";"Torrey Mitchell";22;0,72;82;10;10;-3;20
"902";"LW";"Travis Moen";25;0,9;77;3;5;-10;8
"903";"C";"Travis Zajac";22;0,98;82;14;20;-11;34
"904";"RW";"Trent Hunter";27;1,55;82;12;29;-17;41
"905";"D";"Trevor Daley";24;0,8;82;5;19;-1;24
"906";"RW";"Trevor Letowski";30;0,8;75;9;9;-10;18
"907";"C";"Trevor Linden";37;0,95;59;7;5;0;12
"908";"RW";"Troy Brouwer";22;0,03;2;0;1;1;1
"909";"C";"Tuomo Ruutu";24;2,25;77;10;22;4;32
"910";"G";"Tuukka Rask";20;0,62;4;0;0;0;0
"911";"G";"Ty Conklin";31;0,33;33;0;1;0;1
"912";"C";"Tyler Arnason";28;1,6;70;10;21;-1;31
"913";"RW";"Tyler Kennedy";21;0,45;55;10;9;2;19
"914";"G";"Tyler Weiman";23;0,06;1;0;0;0;0
"915";"C";"Vaclav Prospal";32;1,9;80;33;38;0;71
"916";"C";"Valtteri Filppula";23;0,85;78;19;17;16;36
"917";"C";"Vernon Fiddler";27;0,8;79;11;21;-4;32
"918";"G";"Vesa Toskala";30;1,38;66;0;5;0;5
"919";"C";"Viktor Kozlov";32;2,5;81;16;38;28;54
"920";"D";"Ville Koistinen";25;0,48;48;4;13;13;17
"921";"LW";"Ville Peltonen";34;1;56;5;15;-2;20
"922";"C";"Vincent Lecavalier";27;7,17;81;40;52;-17;92
"923";"D";"Vitali Vishnevsky";27;1,4;69;2;5;-12;7
"924";"C";"Vladimir Sobotka";20;0,49;48;1;6;1;7
"925";"F";"Wade Belak";31;0,62;47;1;0;-2;1
"926";"F";"Wade Brookbank";30;0,27;32;1;1;4;2
"927";"G";"Wade Dubielewicz";28;0,5;20;0;0;0;0
"928";"D";"Wade Redden";30;6,5;80;6;32;11;38
"929";"C";"Wayne Primeau";31;1,4;43;3;7;-3;10
"930";"C";"Wes Walz";37;1,4;11;1;3;-5;4
"931";"D";"Willie Mitchell";30;3,5;72;2;10;6;12
"932";"LW";"Wojtek Wolski";21;0,86;77;18;30;10;48
"933";"C";"Wyatt Smith";30;0,18;25;0;3;-4;3
"934";"C";"Yan Stastny";25;0,14;12;1;1;0;2
"935";"C";"Yanic Perreault";36;1,5;53;9;5;-1;14
"936";"D";"Zack Fitzgerald";22;0,01;1;0;0;0;0
"937";"RW";"Zack Stortini";22;0,51;66;3;9;3;12
"938";"LW";"Zach Parise";23;2;81;32;33;13;65
"939";"D";"Zbynek Michalek";25;1,2;75;4;13;9;17
"940";"D";"Zdeno Chara";30;7,5;77;17;34;14;51
"941";"C";"Zenon Konopka";27;0,06;3;0;0;-1;0
