"";"P";"Player";"Age";"Salary";"GP";"G";"GA";"PlusMin";"NHL"
"1";"RW";"Aaron Downey";34;0,02;4;1;1;0;2
"2";"D";"Aaron Johnson";25;0,51;38;3;5;19;8
"3";"D";"Aaron MacKenzie";27;0,02;5;0;0;1;0
"4";"D";"Aaron Rome";25;0,15;8;0;1;1;1
"5";"LW";"Aaron Voros";27;1,2;54;8;8;-9;16
"6";"D";"Aaron Ward";35;2,5;65;3;7;16;10
"7";"RW";"Adam Burish";25;0,7;66;6;3;3;9
"8";"D";"Adam Foote";37;2,75;42;1;6;-12;7
"9";"RW";"Adam Hall";28;0,6;74;5;5;-9;10
"10";"C";"Adam Mair";29;0,75;75;8;11;4;19
"11";"D";"Adam Pardy";24;0,5;60;1;9;3;10
"12";"D";"Adrian Aucoin";35;4;81;10;24;-8;34
"13";"G";"Al Montoya";23;0,08;5;0;0;0;0
"14";"RW";"Ales Hemsky";25;3,6;72;23;43;1;66
"15";"RW";"Ales Kotalik";30;2,5;75;20;23;-5;43
"16";"G";"Alex Auld";27;1;43;0;0;0;0
"17";"C";"Alex Bolduc";23;0,06;7;0;1;1;1
"18";"RW";"Alex Burrows";27;0,52;82;28;23;23;51
"19";"D";"Alex Edler";22;0,55;80;10;27;11;37
"20";"D";"Alex Goligoski";23;0,65;45;6;14;5;20
"21";"D";"Alex Henry";29;0,01;2;0;0;-2;0
"22";"RW";"Alex Kovalev";35;4,5;78;26;39;-4;65
"23";"LW";"Alex Ovechkin";23;9;79;56;54;8;110
"24";"D";"Alex Pietrangelo";18;0,42;8;0;1;0;1
"25";"C";"Alex Steen";24;1,7;81;8;20;-10;28
"26";"LW";"Alex Tanguay";29;5,38;50;16;25;13;41
"27";"LW";"Alexander Frolov";26;3,5;77;32;27;-6;59
"28";"C";"Alexander Nikulin";23;0,02;1;0;0;-1;0
"29";"LW";"Alexander Semin";24;4,2;62;34;45;25;79
"30";"D";"Alexander Sulzer";24;0,15;2;0;0;0;0
"31";"LW";"Alexandre Giroux";27;0,05;12;1;1;4;2
"32";"LW";"Alexandre Picard";23;0,54;62;6;9;-3;15
"33";"LW";"Alexei Ponikarovsky";28;2,24;82;23;38;6;61
"34";"D";"Alexei Semenov";27;0,65;47;1;7;3;8
"35";"C";"Andre Deveaux";24;0,19;21;0;1;-3;1
"36";"RW";"Andre Roy";33;0,55;44;3;0;-1;3
"37";"D";"Andreas Lilja";33;1,25;60;2;11;13;13
"38";"RW";"Andreas Nodl";21;0,36;38;1;3;-15;4
"39";"RW";"Andrei Kostitsyn";23;3,25;74;23;18;-7;41
"40";"D";"Andrei Markov";30;5,75;78;12;52;-2;64
"41";"D";"Andrej Meszaros";23;2,5;52;2;14;-4;16
"42";"D";"Andrej Sekera";22;0,66;69;3;16;-11;19
"43";"D";"Andrew Alberts";27;1,4;79;1;12;6;13
"44";"LW";"Andrew Brunette";35;2,5;80;22;28;-5;50
"45";"C";"Andrew Cogliano";21;1,13;82;18;20;-6;38
"46";"C";"Andrew Ebbett";25;0,3;48;8;24;8;32
"47";"D";"Andrew Ference";29;1,34;47;1;15;7;16
"48";"RW";"Andrew Gordon";23;0;1;0;0;0;0
"49";"D";"Andrew Hutchinson";28;0,4;40;2;3;-9;5
"50";"LW";"Andrew Ladd";23;1,45;82;15;34;26;49
"51";"D";"Andrew MacDonald";22;0,01;3;0;0;2;0
"52";"C";"Andrew Murray";27;0,6;67;8;3;-6;11
"53";"LW";"Andrew Peters";28;0,55;28;0;1;-2;1
"54";"G";"Andrew Raycroft";28;0,8;31;0;0;0;0
"55";"D";"Andy Greene";26;0,6;49;2;7;3;9
"56";"C";"Andy Hilbert";27;0,7;67;11;16;-3;27
"57";"C";"Andy McDonald";31;3,33;46;15;29;-13;44
"58";"D";"Andy Sutton";33;3;23;2;8;3;10
"59";"D";"Andy Wozniewski";28;0,01;1;0;0;0;0
"60";"D";"Anssi Salmela";24;0,37;26;1;5;1;6
"61";"G";"Antero Niittymaki";28;1,38;32;0;1;0;1
"62";"RW";"Anthony Stewart";23;0,52;59;2;5;-6;7
"63";"C";"Antoine Vermette";26;2,52;79;16;25;-7;41
"64";"D";"Anton Babchuk";24;1;72;16;19;13;35
"65";"D";"Anton Stralman";22;0,4;38;1;12;-2;13
"66";"D";"Anton Volchenkov";26;2,2;68;2;8;-10;10
"67";"LW";"Antti Miettinen";28;2;82;15;29;-1;44
"68";"G";"Antti Niemi";25;0,21;3;0;0;0;0
"69";"LW";"Antti Pihlstrom";24;0,43;53;2;5;-1;7
"70";"C";"Anze Kopitar";21;0,96;82;27;39;-17;66
"71";"RW";"Arron Asham";30;0,64;78;8;12;0;20
"72";"C";"Artem Anisimov";20;0,01;1;0;0;0;0
"73";"RW";"B.J. Crombeen";23;0,55;81;12;10;-9;22
"74";"D";"Barret Jackman";27;2,5;82;4;17;-17;21
"75";"RW";"Barry Tallackson";25;0,15;4;0;0;-1;0
"76";"G";"Ben Bishop";22;0,33;6;0;0;0;0
"77";"LW";"Ben Eager";24;0,6;75;11;4;1;15
"78";"C";"Ben Guite";30;0,48;50;5;7;2;12
"79";"D";"Ben Lovejoy";24;0,01;2;0;0;0;0
"80";"C";"Ben Maxwell";20;0,09;7;0;0;-1;0
"81";"RW";"Ben Ondrus";26;0,06;11;0;0;-4;0
"82";"C";"Ben Walter";24;0,12;4;0;0;-2;0
"83";"LW";"Benoit Pouliot";22;0,9;37;5;6;1;11
"84";"RW";"Bill Guerin";38;4,5;78;21;27;-12;48
"85";"C";"Bill Thomas";25;0,16;16;2;1;-4;3
"86";"C";"Blair Betts";28;0,62;81;6;4;-5;10
"87";"RW";"Blake Comeau";22;0,46;53;7;18;-17;25
"88";"RW";"Blake Wheeler";22;2,83;81;21;24;36;45
"89";"C";"Bobby Holik";38;2,5;62;4;5;-2;9
"90";"RW";"Bobby Ryan";21;1,54;64;31;26;13;57
"91";"D";"Boris Valabik";22;0,73;50;0;5;-14;5
"92";"C";"Boyd Devereaux";30;0,18;23;6;5;3;11
"93";"C";"Boyd Gordon";25;0,72;63;5;9;-4;14
"94";"LW";"Boyd Kane";30;0,01;1;0;0;0;0
"95";"C";"Brad Boyes";26;2,5;82;33;39;-20;72
"96";"D";"Brad Lukowich";32;1,65;58;0;8;5;8
"97";"LW";"Brad May";37;0,6;58;1;6;0;7
"98";"C";"Brad Richards";28;7,8;56;16;32;-4;48
"99";"C";"Brad Richardson";23;0,57;31;0;5;-6;5
"100";"LW";"Brad Staubitz";24;0,19;35;1;2;0;3
"101";"D";"Brad Stuart";29;3,75;67;2;13;-3;15
"102";"LW";"Brad Winchester";27;0,46;64;13;8;-1;21
"103";"RW";"Brandon Bochenski";26;0,04;7;0;1;-3;1
"104";"C";"Brandon Dubinsky";22;0,64;82;13;28;-6;41
"105";"LW";"Brandon Prust";24;0,48;36;1;2;-8;3
"106";"RW";"Brandon Segal";25;0;2;0;0;0;0
"107";"C";"Brandon Sutter";19;1,04;50;1;5;-1;6
"108";"D";"Braydon Coburn";23;1,2;80;7;21;7;28
"109";"D";"Brendan Bell";25;0,4;53;6;15;-5;21
"110";"D";"Brendan Mikkelson";21;0,35;34;0;2;0;2
"111";"C";"Brendan Morrison";33;2,75;81;16;15;3;31
"112";"LW";"Brendan Shanahan";39;0,38;34;6;8;-2;14
"113";"D";"Brendan Witt";33;2,62;65;0;9;-34;9
"114";"LW";"Brenden Morrow";29;4,1;18;5;10;-4;15
"115";"D";"Brent Burns";23;3;59;8;19;-7;27
"116";"G";"Brent Johnson";31;0,82;21;0;1;0;1
"117";"G";"Brent Krahn";26;0,05;1;0;0;0;0
"118";"D";"Brent Seabrook";23;3,5;82;8;18;23;26
"119";"D";"Brent Sopel";31;2,5;23;1;1;-4;2
"120";"D";"Bret Hedican";38;0,8;51;1;5;-7;6
"121";"D";"Brett Carson";23;0,03;5;0;0;-3;0
"122";"D";"Brett Clark";32;3,5;76;2;10;-16;12
"123";"D";"Brett Festerling";22;0,27;40;0;5;5;5
"124";"D";"Brett Lebda";26;0,65;65;6;10;9;16
"125";"C";"Brett McLean";30;1,7;80;7;12;-11;19
"126";"D";"Brett Skinner";25;0,55;11;0;0;2;0
"127";"LW";"Brett Sterling";24;0,1;6;1;0;-3;1
"128";"C";"Brett Sutter";21;0,03;4;1;0;-2;1
"129";"G";"Brian Boucher";31;0,65;22;0;0;0;0
"130";"C";"Brian Boyle";24;0,39;28;4;1;-9;5
"131";"D";"Brian Campbell";29;7,14;82;7;45;5;52
"132";"G";"Brian Elliott";23;0,5;31;0;0;0;0
"133";"RW";"Brian Gionta";29;4;81;20;40;12;60
"134";"D";"Brian Lee";21;0,8;53;2;11;-2;13
"135";"RW";"Brian McGrattan";27;0,3;5;0;0;-2;0
"136";"D";"Brian Pothier";31;2,5;9;1;2;0;3
"137";"D";"Brian Rafalski";35;6;78;10;49;17;59
"138";"LW";"Brian Rolston";35;5,25;64;15;17;2;32
"139";"D";"Brian Salcido";23;0,04;2;0;1;2;1
"140";"C";"Brian Sutherby";26;0,7;59;8;7;1;15
"141";"RW";"Brian Willsie";30;0,46;42;1;3;-6;4
"142";"C";"Brooks Laich";25;1,7;82;23;30;-1;53
"143";"D";"Brooks Orpik";28;3,75;79;2;17;10;19
"144";"D";"Bruno Gervais";24;0,52;69;3;16;-15;19
"145";"D";"Bryan Allen";28;3;2;0;1;2;1
"146";"D";"Bryan Helmer";36;0,05;12;0;3;-1;3
"147";"C";"Bryan Little";21;0,85;79;31;20;-5;51
"148";"D";"Bryan McCabe";33;6,15;69;15;24;-1;39
"149";"D";"Bryan Rodney";24;0,05;8;0;2;-3;2
"150";"D";"Bryce Salvador";32;2,9;76;3;13;-1;16
"151";"RW";"Byron Bitz";24;0,37;35;4;3;0;7
"152";"RW";"Cal Clutterbuck";21;0,7;78;11;7;-5;18
"153";"C";"Cal O'Reilly";22;0,06;11;3;2;2;5
"154";"D";"Cam Barker";22;2,42;68;6;34;-6;40
"155";"RW";"Cam Janssen";24;0,55;56;1;3;-5;4
"156";"C";"Cam Paddock";25;0,1;16;2;1;-4;3
"157";"G";"Cam Ward";24;2,5;68;0;1;0;1
"158";"G";"Carey Price";21;2,2;52;0;1;0;1
"159";"D";"Carlo Colaiacovo";25;1,4;73;3;27;0;30
"160";"D";"Casey Borer";23;0,02;3;0;0;0;0
"161";"LW";"Clarke MacArthur";23;0,52;71;17;14;-4;31
"162";"C";"Claude Giroux";20;0,46;42;9;18;10;27
"163";"RW";"Claude Lemieux";43;0,23;18;0;1;-5;1
"164";"D";"Clay Wilson";25;0,06;7;0;1;-3;1
"165";"C";"Cody Bass";21;0,38;12;0;0;-2;0
"166";"RW";"Cody McCormick";25;0,51;55;1;11;-5;12
"167";"LW";"Cody McLeod";24;0,52;79;15;5;-11;20
"168";"RW";"Colby Armstrong";26;1,2;82;22;18;5;40
"169";"C";"Colin Fraser";23;0,5;81;6;11;3;17
"170";"LW";"Colin Stuart";26;0,2;33;5;3;3;8
"171";"D";"Colin White";31;3;71;1;17;18;18
"172";"C";"Colton Gillies";19;1,04;45;2;5;-2;7
"173";"RW";"Colton Orr";26;0,55;82;1;4;-15;5
"174";"C";"Connor James";26;0;1;0;0;0;0
"175";"RW";"Corey Perry";23;4,3;78;32;40;10;72
"176";"D";"Corey Potter";24;0,07;5;1;1;-1;2
"177";"D";"Cory Murphy";30;0,88;32;5;11;-4;16
"178";"D";"Cory Sarich";30;3,4;76;2;18;12;20
"179";"G";"Cory Schneider";22;0,26;8;0;0;0;0
"180";"LW";"Cory Stillman";35;3,6;63;17;32;1;49
"181";"RW";"Craig Adams";31;0,6;45;2;5;-3;7
"182";"G";"Craig Anderson";27;0,57;31;0;1;0;1
"183";"C";"Craig Conroy";37;1,1;82;12;36;20;48
"184";"C";"Craig MacDonald";31;0,06;8;1;1;1;2
"185";"D";"Craig Rivet";34;3,5;64;2;22;4;24
"186";"RW";"Craig Weller";27;0,57;36;1;2;-3;3
"187";"G";"Cristobal Huet";33;5,62;41;0;0;0;0
"188";"LW";"Curtis Glencross";26;1,2;74;13;27;14;40
"189";"G";"Curtis Joseph";41;0,7;21;0;0;0;0
"190";"G";"Curtis McElhinney";25;0,5;14;0;0;0;0
"191";"G";"Curtis Sanford";29;0,34;19;0;0;0;0
"192";"RW";"Chad LaRose";26;0,88;81;19;12;6;31
"193";"LW";"Chris Bourque";22;0,05;8;1;0;0;1
"194";"D";"Chris Butler";22;0,51;47;2;4;11;6
"195";"D";"Chris Campoli";24;0,62;76;11;19;-16;30
"196";"RW";"Chris Clark";32;2,75;32;1;5;-3;6
"197";"RW";"Chris Conner";25;0,3;38;3;10;-5;13
"198";"D";"Chris Chelios";46;0,75;28;0;0;1;0
"199";"C";"Chris Drury";32;7,1;81;22;34;-8;56
"200";"LW";"Chris Durno";28;0,02;2;0;0;0;0
"201";"C";"Chris Gratton";33;0,75;24;0;3;-1;3
"202";"C";"Chris Higgins";25;1,9;57;12;11;-1;23
"203";"G";"Chris Holt";23;0,08;1;0;0;0;0
"204";"C";"Chris Kelly";28;2,5;82;12;11;-10;23
"205";"LW";"Chris Kunitz";29;3,5;82;23;30;12;53
"206";"G";"Chris Mason";32;3;57;0;1;0;1
"207";"C";"Chris Minard";27;0,15;20;1;2;0;3
"208";"RW";"Chris Neil";29;1,2;60;3;7;-13;10
"209";"G";"Chris Osgood";36;1,7;46;0;2;0;2
"210";"D";"Chris Phillips";30;3,5;82;6;16;-14;22
"211";"F";"Chris Porter";24;0,08;6;1;1;-1;2
"212";"D";"Chris Pronger";34;6,25;82;11;37;0;48
"213";"LW";"Chris Stewart";21;0,59;53;11;8;-18;19
"214";"RW";"Chris Thorburn";25;0,54;82;7;8;-10;15
"215";"D";"Christian Backman";28;3,4;56;2;5;5;7
"216";"D";"Christian Ehrhoff";26;2,75;77;8;34;-12;42
"217";"RW";"Christian Hanson";22;0,06;5;1;1;-1;2
"218";"D";"Christoph Schubert";26;0,9;50;3;3;-8;6
"219";"RW";"Chuck Kobasew";26;2;68;21;21;5;42
"220";"LW";"D.J. King";24;0,55;1;0;1;0;1
"221";"C";"Dainius Zubrus";30;3,4;82;15;25;6;40
"222";"D";"Dan Boyle";32;6,67;77;16;41;6;57
"223";"LW";"Dan Carcillo";23;0,83;74;3;11;-15;14
"224";"G";"Dan Ellis";28;1,5;35;0;0;0;0
"225";"C";"Dan Fritsche";23;0,88;50;5;8;-5;13
"226";"D";"Dan Girardi";24;1,5;82;4;18;-14;22
"227";"D";"Dan Hamhuis";26;2,25;82;3;23;-4;26
"228";"RW";"Dan Hinote";31;1;51;1;4;-7;5
"229";"D";"Dan Jancevski";27;0,02;3;0;0;0;0
"230";"G";"Dan LaCosta";22;0,08;3;0;0;0;0
"231";"LW";"Dan LaCouture";31;0,07;11;2;0;-1;2
"232";"G";"Dan Sabourin";28;0,52;19;0;0;0;0
"233";"RW";"Daniel Alfredsson";36;5,47;79;24;50;7;74
"234";"C";"Daniel Briere";31;8;29;11;14;-1;25
"235";"LW";"Daniel Cleary";30;2,5;74;14;26;0;40
"236";"LW";"Daniel Paille";24;0,9;73;12;15;0;27
"237";"LW";"Daniel Sedin";28;3,58;82;31;51;24;82
"238";"D";"Daniel Tjarnqvist";32;0,75;37;2;2;1;4
"239";"LW";"Daniel Winnik";23;0,51;49;3;4;1;7
"240";"D";"Danny Syvret";23;0,02;2;0;0;-1;0
"241";"RW";"Dany Heatley";27;10;82;39;33;-11;72
"242";"LW";"Darcy Hordichuk";28;0,75;73;4;1;1;5
"243";"LW";"Darcy Tucker";33;2,2;63;8;8;-13;16
"244";"C";"Darren Helm";21;0,1;16;0;1;-7;1
"245";"RW";"Darren McCarty";36;0,42;13;1;0;-2;1
"246";"C";"Darroll Powe";23;0,45;60;6;5;-8;11
"247";"D";"Darryl Sydor";36;2,5;73;3;12;3;15
"248";"C";"Dave Bolland";22;0,89;81;19;28;19;47
"249";"C";"Dave Steckel";26;0,5;76;8;11;2;19
"250";"RW";"David Backes";24;2,5;82;31;23;-3;54
"251";"LW";"David Booth";24;0,68;72;31;29;10;60
"252";"RW";"David Clarkson";24;0,8;82;17;15;-1;32
"253";"D";"David Hale";27;0,68;48;3;6;-11;9
"254";"RW";"David Jones";24;0,55;40;8;5;-8;13
"255";"D";"David Koci";27;0,52;37;1;1;1;2
"256";"C";"David Krejci";22;0,88;82;22;51;37;73
"257";"C";"David Legwand";28;5,5;73;20;22;-3;42
"258";"RW";"David Moss";27;0,57;81;20;19;-5;39
"259";"C";"David Perron";20;0,92;81;15;35;13;50
"260";"D";"David Schlemko";21;0,04;3;0;1;-2;1
"261";"D";"David Sloane";23;NA;1;0;0;0;0
"262";"RW";"David Van der Gulik";25;0,03;6;0;2;-1;2
"263";"D";"Davis Drewiske";24;0,1;17;0;3;1;3
"264";"C";"Daymond Langkow";32;5;73;21;28;1;49
"265";"LW";"Dean McAmmond";35;0,88;62;5;11;7;16
"266";"D";"Denis Gauthier";32;1,93;65;2;2;-11;4
"267";"D";"Denis Grebeshkov";25;1,5;72;7;32;12;39
"268";"D";"Dennis Seidenberg";27;1,2;70;5;25;-9;30
"269";"D";"Dennis Wideman";25;3,25;79;13;37;32;50
"270";"C";"Derek Armstrong";35;1,6;56;5;4;-11;9
"271";"LW";"Derek Boogaard";26;0,8;51;0;3;3;3
"272";"RW";"Derek Dorsett";22;0,52;52;4;1;-1;5
"273";"D";"Derek Joslin";21;0,1;12;0;0;-3;0
"274";"C";"Derek MacKenzie";27;0,01;1;0;0;-1;0
"275";"D";"Derek Meech";24;0,48;41;2;5;-12;7
"276";"D";"Derek Morris";30;3,95;75;5;15;-10;20
"277";"D";"Derek Peltier";23;0,07;11;0;0;-4;0
"278";"C";"Derek Roy";25;3,5;82;28;42;-5;70
"279";"C";"Derick Brassard";21;1,25;31;10;15;12;25
"280";"RW";"Devin Setoguchi";22;1,25;81;31;34;16;65
"281";"D";"Dion Phaneuf";23;7;80;11;36;-11;47
"282";"D";"Dmitri Kalinin";28;2,1;73;2;15;-9;17
"283";"C";"Dominic Moore";28;0,9;81;13;32;-2;45
"284";"LW";"Donald Brashear";36;1,2;63;1;3;-6;4
"285";"D";"Doug Janik";28;0,5;15;0;1;-3;1
"286";"D";"Doug Murray";28;0,6;75;0;7;6;7
"287";"C";"Doug Weight";37;4,3;53;10;28;-15;38
"288";"D";"Drew Doughty";19;3,48;81;6;21;-17;27
"289";"LW";"Drew Miller";24;0,17;27;4;6;0;10
"290";"RW";"Drew Stafford";23;0,98;79;20;25;3;45
"291";"D";"Duncan Keith";25;1,6;77;8;36;33;44
"292";"C";"Dustin Boyd";22;0,7;71;11;11;-11;22
"293";"RW";"Dustin Brown";24;2,6;80;24;29;-15;53
"294";"D";"Dustin Byfuglien";23;3;77;15;16;7;31
"295";"C";"Dustin Jeffrey";20;0,07;14;1;2;4;3
"296";"RW";"Dustin Penner";26;4,25;78;17;20;7;37
"297";"G";"Dwayne Roloson";39;3;63;0;1;0;1
"298";"C";"Dwight Helminen";25;0,15;23;1;1;-2;2
"299";"D";"Ed Jovanovski";32;6,5;82;9;27;-15;36
"300";"RW";"Enver Lisin";22;0,79;48;13;8;-13;21
"301";"C";"Eric Belanger";31;1,75;79;13;23;-5;36
"302";"LW";"Eric Boulton";32;0,6;76;3;10;-3;13
"303";"D";"Eric Brewer";29;4,5;28;1;5;-14;6
"304";"RW";"Eric Fehr";23;0,74;61;12;13;8;25
"305";"RW";"Eric Godard";28;0,72;71;2;2;-3;4
"306";"LW";"Eric Nystrom";25;0,6;76;5;5;-7;10
"307";"C";"Eric Perrin";33;0,75;78;7;16;-2;23
"308";"C";"Eric Staal";24;5;82;40;35;15;75
"309";"LW";"Erik Cole";30;4;80;18;24;0;42
"310";"C";"Erik Christensen";25;0,75;64;7;21;-9;28
"311";"G";"Erik Ersberg";26;0,7;28;0;0;0;0
"312";"D";"Erik Johnson";20;3,7;0;0;0;0;0
"313";"D";"Erik Reitz";26;0,2;42;1;1;-6;2
"314";"LW";"Ethan Moreau";33;1,75;77;14;12;0;26
"315";"RW";"Evgeni Artyukhin";25;0,89;73;6;10;1;16
"316";"C";"Evgeni Malkin";22;3,83;82;35;78;17;113
"317";"G";"Evgeni Nabokov";33;5,5;62;0;1;0;1
"318";"C";"Fabian Brunnstrom";23;2,18;55;17;12;-8;29
"319";"D";"Fedor Tyutin";25;2,25;82;9;25;1;34
"320";"RW";"Fernando Pisani";32;2,5;38;7;8;-1;15
"321";"D";"Filip Kuba";32;3;71;3;37;4;40
"322";"D";"Francis Bouillon";33;1,88;54;5;4;-7;9
"323";"D";"Francois Beauchemin";28;1,65;20;4;1;-3;5
"324";"C";"Frans Nielsen";24;0,5;59;9;24;-4;33
"325";"D";"Frantisek Kaberle";35;2,2;30;1;7;-4;8
"326";"D";"Freddy Meyer";27;0,57;27;4;5;-19;9
"327";"LW";"Fredrik Modin";34;3,5;50;9;16;2;25
"328";"G";"Fredrik Norrena";35;0,31;8;0;0;0;0
"329";"RW";"Fredrik Sjostrom";25;0,84;79;7;6;-11;13
"330";"D";"Garnet Exelby";27;1,4;59;0;7;-2;7
"331";"D";"Garrett Stafford";28;0,02;3;0;2;0;2
"332";"C";"Garth Murray";26;0,08;10;0;0;-2;0
"333";"LW";"Gary Roberts";42;2,07;30;4;3;-11;7
"334";"D";"Geoff Kinrade";23;NA;1;0;0;-1;0
"335";"RW";"George Parros";29;0,57;74;5;5;8;10
"336";"RW";"Georges Laraque";32;1,5;33;0;2;-6;2
"337";"C";"Gilbert Brule";22;0,19;11;2;1;-3;3
"338";"C";"Glen Metropolit";34;1;76;6;11;-6;17
"339";"RW";"Graham Mink";29;0,01;2;0;0;0;0
"340";"D";"Grant Lewis";23;0,01;1;0;0;0;0
"341";"LW";"Greg Campbell";25;0,72;77;13;19;0;32
"342";"D";"Greg De Vries";35;2,75;71;1;4;-15;5
"343";"LW";"Greg Stewart";22;0,16;20;0;1;-4;1
"344";"D";"Greg Zanon";28;0,75;82;4;7;8;11
"345";"LW";"Guillaume Latendresse";21;0,85;56;14;12;4;26
"346";"D";"Hal Gill";33;2,1;62;2;8;11;10
"347";"G";"Henrik Lundqvist";26;7,75;70;0;2;0;2
"348";"C";"Henrik Sedin";28;3,58;82;22;60;22;82
"349";"D";"Henrik Tallinder";29;2,9;66;1;11;-2;12
"350";"C";"Henrik Zetterberg";28;2,9;77;31;42;13;73
"351";"C";"Ian Laperriere";34;1,15;74;7;12;0;19
"352";"D";"Ian White";24;0,85;71;10;16;6;26
"353";"G";"Ilya Bryzgalov";28;4;65;0;2;0;2
"354";"LW";"Ilya Kovalchuk";25;7,5;79;43;48;-12;91
"355";"C";"Ilya Zubov";21;0,13;10;0;2;-1;2
"356";"D";"Ivan Vishnevskiy";20;0,07;3;0;2;1;2
"357";"RW";"J.P. Dumont";30;4;82;16;49;1;65
"358";"D";"Jack Hillen";22;0,26;40;1;5;-9;6
"359";"D";"Jack Johnson";21;2,15;41;6;5;-18;11
"360";"LW";"Jack Skille";21;0,31;8;1;0;-3;1
"361";"C";"Jake Dowell";23;0;1;0;0;1;0
"362";"C";"Jakub Petruzalek";23;0,01;2;0;1;1;1
"363";"RW";"Jakub Voracek";19;1,27;80;9;29;11;38
"364";"RW";"Jamal Mayers";34;1,4;71;7;9;-7;16
"365";"LW";"James Neal";21;0,75;77;24;13;-11;37
"366";"C";"James Sheppard";20;1,4;82;5;19;-14;24
"367";"D";"James Wisniewski";24;0,9;48;3;21;9;24
"368";"D";"Jamie Fraser";23;0;1;0;0;0;0
"369";"D";"Jamie Fritsch";23;NA;1;0;0;1;0
"370";"D";"Jamie Heward";37;0,24;13;0;2;-1;2
"371";"RW";"Jamie Langenbrunner";33;2,8;81;29;40;25;69
"372";"C";"Jamie Lundmark";27;0,18;27;8;8;2;16
"373";"LW";"Jamie McGinn";20;0,41;35;4;2;-6;6
"374";"D";"Jamie Sifers";25;0,17;23;0;2;-4;2
"375";"D";"Jan Hejda";30;2;82;3;18;23;21
"376";"C";"Janis Sprukts";27;0;1;0;0;0;0
"377";"D";"Janne Niskala";27;0,09;6;1;2;0;3
"378";"LW";"Janne Pesonen";26;0,06;7;0;0;-3;0
"379";"LW";"Jannik Hansen";22;0,5;55;6;15;5;21
"380";"RW";"Jared Boll";22;0,74;75;4;10;-6;14
"381";"C";"Jared Ross";26;0,08;10;0;0;-4;0
"382";"LW";"Jarkko Ruutu";33;1,25;78;7;14;0;21
"383";"RW";"Jarome Iginla";31;7;82;35;54;-2;89
"384";"G";"Jaroslav Halak";23;0,75;34;0;0;0;0
"385";"D";"Jaroslav Spacek";34;3,3;80;8;37;2;45
"386";"C";"Jarret Stoll";26;4,1;74;18;23;-7;41
"387";"C";"Jason Arnott";34;4,5;65;33;24;2;57
"388";"LW";"Jason Blake";35;4,5;78;25;38;-2;63
"389";"LW";"Jason Chimera";29;1,88;49;8;14;8;22
"390";"D";"Jason Garrison";24;0,01;1;0;0;0;0
"391";"LW";"Jason Jaffray";27;0,11;14;2;2;-2;4
"392";"C";"Jason Krog";33;0,05;4;1;0;0;1
"393";"G";"Jason Labarbera";28;0,85;28;0;0;0;0
"394";"RW";"Jason Pominville";26;1,38;82;20;46;-4;66
"395";"D";"Jason Smith";35;2,6;63;1;0;-3;1
"396";"C";"Jason Spezza";25;8;82;32;41;-14;73
"397";"D";"Jason Strudwick";33;0,65;71;2;7;-4;9
"398";"RW";"Jason Ward";29;0,11;1;0;0;0;0
"399";"C";"Jason Williams";28;2,2;80;19;28;-4;47
"400";"D";"Jassen Cullimore";36;0,74;68;2;8;-10;10
"401";"C";"Jay Beagle";23;0,03;3;0;0;-3;0
"402";"D";"Jay Bouwmeester";25;4,88;82;15;27;-2;42
"403";"D";"Jay Harrison";26;0,04;7;0;1;-2;1
"404";"D";"Jay Leach";29;0,37;24;0;1;0;1
"405";"C";"Jay McClement";25;0,95;82;12;14;-10;26
"406";"D";"Jay McKee";31;4;69;1;7;11;8
"407";"LW";"Jay Pandolfo";34;2,5;61;5;5;-12;10
"408";"LW";"Jean-Francois Jacques";23;0,5;7;1;0;0;1
"409";"G";"Jean-Sebastien Giguere";31;5,5;46;0;0;0;0
"410";"RW";"Jed Ortmeyer";30;0,26;2;0;0;0;0
"411";"C";"Jeff Carter";24;4,5;82;46;38;23;84
"412";"G";"Jeff Deslauriers";24;0,55;10;0;1;0;1
"413";"D";"Jeff Finger";29;3,5;66;6;17;-7;23
"414";"C";"Jeff Halpern";32;2;52;7;9;-13;16
"415";"RW";"Jeff Hamilton";31;0,1;15;3;3;2;6
"416";"LW";"Jeff Hoggan";30;0,02;4;0;1;-1;1
"417";"D";"Jeff Schultz";22;0,65;64;1;11;13;12
"418";"C";"Jeff Taffe";27;0,04;8;0;2;-4;2
"419";"LW";"Jeff Tambellini";24;0,54;65;7;8;-20;15
"420";"D";"Jeff Woywitka";25;0,64;65;3;15;8;18
"421";"LW";"Jere Lehtinen";35;4,1;48;8;16;1;24
"422";"C";"Jeremy Colliton";23;0,03;6;0;1;-2;1
"423";"C";"Jeremy Roenick";38;1,1;42;4;9;-1;13
"424";"RW";"Jeremy Williams";24;0,18;11;5;2;2;7
"425";"C";"Jerred Smithson";29;0,52;82;4;9;-6;13
"426";"RW";"Jesse Boulerice";30;0,03;2;0;0;0;0
"427";"LW";"Jesse Joensuu";21;0,04;7;1;2;-1;3
"428";"C";"Jesse Winchester";25;0,52;76;3;15;0;18
"429";"C";"Jim Slater";26;0,8;60;8;10;0;18
"430";"D";"Jim Vandermeer";28;2,3;45;1;6;1;7
"431";"G";"Jimmy Howard";24;0,04;1;0;0;0;0
"432";"LW";"Jiri Hudler";24;1,15;82;23;34;7;57
"433";"C";"Jiri Novotny";25;0,8;42;4;3;4;7
"434";"LW";"Jiri Tlusty";20;0,15;14;0;4;0;4
"435";"LW";"Joakim Lindstrom";25;0,5;44;9;11;-6;20
"436";"C";"Jochen Hecht";31;3,8;70;12;15;-9;27
"437";"LW";"Jody Shelley";32;0,72;70;2;2;-6;4
"438";"D";"Joe Callahan";26;0,09;18;0;2;5;2
"439";"D";"Joe Corvo";31;2,75;81;14;24;-1;38
"440";"RW";"Joe Motzko";28;0,04;6;1;0;1;1
"441";"C";"Joe Pavelski";24;1,55;80;25;34;5;59
"442";"C";"Joe Sakic";39;6;15;2;10;-6;12
"443";"C";"Joe Thornton";29;7,2;82;25;61;16;86
"444";"C";"Joel Lundqvist";26;0,75;43;1;5;-9;6
"445";"C";"Joel Perrault";25;0,22;7;2;1;2;3
"446";"RW";"Joel Rechlicz";21;0,05;17;0;1;-1;1
"447";"RW";"Joel Ward";28;0,5;79;17;18;1;35
"448";"RW";"Joey Crabb";25;0,22;29;4;5;-2;9
"449";"G";"Joey MacDonald";28;0,5;49;0;1;0;1
"450";"RW";"Joffrey Lupul";25;2,9;79;25;25;1;50
"451";"C";"Johan Franzen";29;1,15;71;34;25;21;59
"452";"G";"Johan Hedberg";35;1;33;0;0;0;0
"453";"D";"John-Michael Liles";28;3,7;75;12;27;-19;39
"454";"G";"John Curry";24;0,06;3;0;0;0;0
"455";"D";"John Erskine";28;0,55;52;0;4;1;4
"456";"C";"John Madden";35;2,94;76;7;16;-7;23
"457";"C";"John Mitchell";23;0,48;76;12;17;-16;29
"458";"D";"John Negrin";19;0,03;3;0;1;-2;1
"459";"LW";"John Scott";26;0,2;20;0;1;-1;1
"460";"RW";"John Zeiler";26;0,5;27;0;1;-2;1
"461";"D";"Johnny Boychuk";24;0,02;1;0;0;0;0
"462";"D";"Johnny Oduya";27;0,6;82;7;22;21;29
"463";"LW";"Jon Kalinski";21;0,35;12;1;2;-2;3
"464";"G";"Jon Quick";22;0,49;44;0;1;0;1
"465";"LW";"Jon Sim";31;0,78;49;9;6;-12;15
"466";"D";"Jonas Frogren";28;1,23;41;1;6;0;7
"467";"G";"Jonas Hiller";26;1,3;46;0;0;0;0
"468";"D";"Jonas Junland";21;0,08;1;0;0;0;0
"469";"RW";"Jonathan Cheechoo";28;3;66;12;17;-3;29
"470";"D";"Jonathan Ericsson";24;0,2;19;1;3;-1;4
"471";"C";"Jonathan Toews";20;2,8;82;34;35;12;69
"472";"D";"Joni Pitkanen";25;3,5;71;7;26;11;33
"473";"D";"Jordan Hendry";24;0,07;9;0;0;-1;0
"474";"LW";"Jordan LaVallee-Smotherman";22;0,04;2;0;0;-1;0
"475";"D";"Jordan Leopold";28;1,5;83;7;17;-15;24
"476";"C";"Jordan Staal";20;2,2;82;22;27;5;49
"477";"RW";"Jordin Tootoo";25;0,98;72;4;12;-15;16
"478";"G";"Jose Theodore";32;4,5;57;0;3;0;3
"479";"D";"Josef Melichar";29;1;39;0;9;0;9
"480";"C";"Josh Bailey";19;1,73;68;7;18;-14;25
"481";"D";"Josh Gorges";24;1;81;4;19;12;23
"482";"LW";"Josh Gratton";26;0,27;19;1;2;-2;3
"483";"G";"Josh Harding";24;0,75;19;0;0;0;0
"484";"C";"Josh Hennessy";23;0,01;1;0;0;0;0
"485";"G";"Josh Tordjman";23;0,06;2;0;0;0;0
"486";"C";"Jussi Jokinen";25;1,88;71;7;20;-10;27
"487";"LW";"Justin Abdelkader";21;0,02;2;0;0;0;0
"488";"G";"Justin Pogge";22;0,11;7;0;0;0;0
"489";"RW";"Justin Williams";27;3,5;44;4;10;-8;14
"490";"C";"Kamil Kreps";24;0,56;66;4;15;3;19
"491";"G";"Kari Lehtonen";25;3;46;0;1;0;1
"492";"D";"Karl Alzner";20;0,59;30;1;4;-1;5
"493";"D";"Karlis Skrastins";34;2,4;80;4;14;9;18
"494";"G";"Karri Ramo";22;0,36;24;0;1;0;1
"495";"C";"Keith Aucoin";30;0,06;12;2;4;5;6
"496";"D";"Keith Ballard";26;2,5;82;6;28;14;34
"497";"LW";"Keith Tkachuk";36;4,5;79;25;24;-11;49
"498";"D";"Keith Yandle";22;0,85;69;4;26;-4;30
"499";"D";"Ken Klee";37;1,25;71;1;10;9;11
"500";"LW";"Kenndal McArdle";21;0,03;3;0;0;-1;0
"501";"D";"Kent Huskins";29;0,65;33;2;4;6;6
"502";"D";"Kevin Bieksa";27;4,25;72;11;32;-4;43
"503";"D";"Kevin Klein";24;0,5;63;4;8;-2;12
"504";"C";"Kevin Porter";22;0,46;34;5;5;-2;10
"505";"D";"Kevin Quick";20;0,04;6;0;1;0;1
"506";"G";"Kevin Weekes";33;0,7;16;0;0;0;0
"507";"RW";"Kevin Westgarth";24;0,11;9;0;0;1;0
"508";"D";"Kim Johnsson";32;5,25;81;2;22;-3;24
"509";"D";"Kimmo Timonen";33;8;77;3;40;19;43
"510";"LW";"Kirk Maltby";36;0,95;78;5;6;-9;11
"511";"RW";"Kris Chucko";22;0,01;2;0;0;0;0
"512";"C";"Kris Draper";37;1,85;79;7;10;-13;17
"513";"D";"Kris Letang";21;0,68;74;10;23;-7;33
"514";"C";"Kris Newbury";26;0,01;1;0;0;0;0
"515";"D";"Kris Russell";21;0,63;66;2;19;-10;21
"516";"LW";"Kris Versteeg";22;0,48;78;22;31;15;53
"517";"LW";"Kristian Huselius";30;4,75;74;21;35;1;56
"518";"RW";"Krys Barch";28;0,57;72;4;5;1;9
"519";"C";"Krys Kolanos";27;0,18;21;3;3;3;6
"520";"D";"Kurt Sauer";27;1,75;68;1;6;-1;7
"521";"D";"Kurtis Foster";27;1,02;10;1;5;7;6
"522";"C";"Kurtis McLean";28;0,11;4;1;0;1;1
"523";"C";"Kyle Brodziak";24;0,5;79;11;16;4;27
"524";"LW";"Kyle Calder";29;2,7;74;8;19;-1;27
"525";"D";"Kyle Cumiskey";22;0,33;6;0;0;-2;0
"526";"C";"Kyle Chipchura";22;0,25;13;0;3;-6;3
"527";"LW";"Kyle Greentree";25;0,02;2;0;0;-1;0
"528";"RW";"Kyle Okposo";20;1,66;65;18;21;-6;39
"529";"D";"Kyle Quincey";23;0,5;72;4;34;-5;38
"530";"C";"Kyle Turris";19;2,44;63;8;12;-15;20
"531";"C";"Kyle Wellwood";25;9,87;74;18;9;2;27
"532";"D";"Ladislav Smid";22;0,95;60;0;11;-6;11
"533";"RW";"Landon Wilson";33;0,42;27;2;6;5;8
"534";"D";"Lasse Kukkonen";27;0,67;22;0;2;-2;2
"535";"LW";"Lauri Korpikoski";22;0,96;68;6;8;-10;14
"536";"D";"Lawrence Nycholat";29;0,6;19;0;1;1;1
"537";"RW";"Lee Stempniak";25;2,5;75;14;30;-12;44
"538";"LW";"Liam Reddox";22;0,4;46;5;7;-6;12
"539";"LW";"Loui Eriksson";23;1,5;82;36;27;14;63
"540";"D";"Lubomir Visnovsky";32;7;50;8;23;6;31
"541";"LW";"Luca Caputi";20;0,04;5;1;0;-1;1
"542";"D";"Luca Sbisa";18;0,55;39;0;7;-6;7
"543";"LW";"Lukas Kaspar";23;0,09;13;2;2;0;4
"544";"D";"Lukas Krajicek";25;1,1;71;2;17;-8;19
"545";"D";"Luke Richardson";39;0,5;2;0;0;-3;0
"546";"D";"Luke Schenn";19;2,98;70;2;12;-12;14
"547";"G";"Manny Fernandez";34;4,75;28;0;0;0;0
"548";"G";"Manny Legace";35;1,4;29;0;0;0;0
"549";"C";"Manny Malhotra";28;1,5;77;11;24;9;35
"550";"D";"Marc-Andre Bergeron";28;1,69;72;14;18;5;32
"551";"G";"Marc-Andre Fleury";24;3,5;62;0;1;0;1
"552";"D";"Marc-Andre Gragnani";21;0,04;4;0;0;2;0
"553";"D";"Marc-Edouard Vlasic";21;1,1;82;6;30;15;36
"554";"G";"Marc Denis";31;0,09;1;0;0;0;0
"555";"D";"Marc Methot";23;0,52;66;4;13;7;17
"556";"C";"Marc Pouliot";23;0,72;63;8;12;1;20
"557";"C";"Marc Savard";31;5;82;25;63;25;88
"558";"D";"Marc Staal";21;0,76;82;3;12;-7;15
"559";"C";"Marcel Goc";25;0,78;55;2;9;-6;11
"560";"LW";"Marco Sturm";30;3,5;19;7;6;9;13
"561";"D";"Marek Malik";33;1,16;42;0;5;-3;5
"562";"G";"Marek Schwarz";22;0,07;2;0;0;0;0
"563";"RW";"Marek Svatos";26;1,75;69;14;20;-6;34
"564";"D";"Marek Zidlicky";31;3,5;76;12;30;-12;42
"565";"RW";"Marian Gaborik";26;7,5;17;13;10;3;23
"566";"RW";"Marian Hossa";29;7,45;74;40;31;27;71
"567";"D";"Mark Eaton";31;2;68;4;5;3;9
"568";"D";"Mark Fistric";22;0,34;36;0;4;-1;4
"569";"D";"Mark Giordano";25;0,6;58;2;17;2;19
"570";"RW";"Mark Mancari";23;0,04;7;1;1;-4;2
"571";"RW";"Mark Parrish";31;0,43;44;8;5;-3;13
"572";"RW";"Mark Recchi";40;1,5;80;23;38;-18;61
"573";"D";"Mark Streit";31;4,1;74;16;40;6;56
"574";"D";"Mark Stuart";24;1,1;82;5;12;20;17
"575";"LW";"Markus Naslund";35;5;82;24;22;-10;46
"576";"G";"Martin Biron";31;3,5;55;0;4;0;4
"577";"G";"Martin Brodeur";36;5,2;31;0;0;0;0
"578";"LW";"Martin Erat";27;3,5;71;17;33;-7;50
"579";"G";"Martin Gerber";34;2,84;26;0;1;0;1
"580";"LW";"Martin Hanzal";21;0,98;74;11;20;-4;31
"581";"LW";"Martin Havlat";27;6;81;29;48;29;77
"582";"RW";"Martin Karsums";22;0,3;24;1;5;-8;6
"583";"D";"Martin Skoula";29;1,9;81;4;12;-12;16
"584";"RW";"Martin St. Louis";33;5;82;30;50;4;80
"585";"C";"Martin St. Pierre";25;0,08;14;2;2;-1;4
"586";"C";"Marty Reasoner";31;1;79;14;16;11;30
"587";"G";"Marty Turco";33;5,7;74;0;5;0;5
"588";"LW";"Mason Raymond";23;0,88;72;11;12;2;23
"589";"D";"Mathieu Dandenault";32;1,75;41;4;8;6;12
"590";"G";"Mathieu Garon";30;1;19;0;0;0;0
"591";"D";"Mathieu Schneider";39;5,75;67;9;23;-12;32
"592";"C";"Mats Sundin";37;5,36;41;9;19;-5;28
"593";"LW";"Matt Beleskey";20;0,02;2;0;0;0;0
"594";"RW";"Matt Bradley";30;1;81;5;6;-1;11
"595";"D";"Matt Carkner";28;0;1;0;0;0;0
"596";"D";"Matt Carle";24;2,95;76;5;21;3;26
"597";"G";"Matt Climie";25;0,02;3;0;0;0;0
"598";"LW";"Matt Cooke";30;1,17;76;13;18;0;31
"599";"C";"Matt Cullen";32;2,8;69;22;21;11;43
"600";"RW";"Matt D'Agostini";22;0,37;53;12;9;-17;21
"601";"C";"Matt Ellis";27;0,37;45;7;5;4;12
"602";"D";"Matt Greene";25;1,25;82;2;12;1;14
"603";"RW";"Matt Halischuk";20;0,02;1;0;1;-1;1
"604";"C";"Matt Hendricks";27;0,06;4;0;0;1;0
"605";"D";"Matt Hunwick";23;0,77;53;6;21;15;27
"606";"D";"Matt Lashoff";22;0,39;28;0;8;-6;8
"607";"LW";"Matt Moulson";25;0,07;7;1;0;-4;1
"608";"D";"Matt Niskanen";22;0,64;80;6;29;-11;35
"609";"RW";"Matt Pelech";21;0,05;5;0;3;1;3
"610";"LW";"Matt Pettinger";28;1,1;59;8;7;-14;15
"611";"D";"Matt Smaby";24;0,48;43;0;4;-11;4
"612";"C";"Matt Stajan";25;1,75;76;15;40;-4;55
"613";"D";"Matt Walker";28;0,6;65;1;13;7;14
"614";"C";"Matthew Lombardi";26;1,55;69;14;32;13;46
"615";"D";"Mattias Ohlund";32;3,5;82;6;19;14;25
"616";"LW";"Max Pacioretty";20;0,39;34;3;8;-3;11
"617";"C";"Max Talbot";24;0,7;75;12;10;-9;22
"618";"RW";"Maxim Afinogenov";29;3,5;48;6;14;-7;20
"619";"C";"Maxim Lapierre";23;0,57;79;15;13;9;28
"620";"RW";"Maxim Mayorov";19;0,05;3;0;0;0;0
"621";"LW";"Michael Frolik";20;1,27;79;21;24;9;45
"622";"G";"Michael Leighton";27;0,6;19;0;0;0;0
"623";"C";"Michael Nylander";36;5,5;72;9;24;0;33
"624";"C";"Michael Peca";34;1,24;71;4;18;-6;22
"625";"C";"Michael Ryan";28;0,18;18;0;2;-3;2
"626";"RW";"Michael Ryder";28;4;74;27;26;28;53
"627";"C";"Michal Handzus";31;4;82;18;24;-7;42
"628";"G";"Michal Neuvirth";20;0,18;5;0;0;0;0
"629";"RW";"Michal Repik";20;0,04;5;2;0;1;2
"630";"D";"Michal Rozsival";30;7;76;8;22;-7;30
"631";"LW";"Michel Ouellet";26;0,05;3;0;0;1;0
"632";"G";"Miikka Kiprusoff";32;8,5;76;0;3;0;3
"633";"C";"Mikael Backlund";19;0,02;1;0;0;0;0
"634";"RW";"Mikael Samuelsson";32;1,2;81;19;21;0;40
"635";"G";"Mikael Tellqvist";29;0,8;21;0;0;0;0
"636";"RW";"Mike Brown";23;0,52;48;2;2;-7;4
"637";"C";"Mike Cammalleri";26;3,6;81;39;43;-2;82
"638";"D";"Mike Commodore";29;4,3;81;5;19;11;24
"639";"C";"Mike Comrie";28;4;63;10;17;-15;27
"640";"C";"Mike Fisher";28;6;78;13;19;0;32
"641";"D";"Mike Green";23;6;68;31;42;24;73
"642";"RW";"Mike Grier";33;1,77;62;10;13;8;23
"643";"C";"Mike Iggulden";26;0,04;11;1;4;-3;5
"644";"RW";"Mike Knuble";36;2,8;82;27;20;5;47
"645";"D";"Mike Komisarek";26;1,9;66;2;9;0;11
"646";"D";"Mike Lundin";24;0,24;25;0;2;-4;2
"647";"G";"Mike McKenna";25;0,18;15;0;1;0;1
"648";"C";"Mike Modano";38;2,25;80;15;31;-13;46
"649";"D";"Mike Mottau";30;0,73;80;1;14;24;15
"650";"C";"Mike Ribeiro";28;5;82;22;56;-4;78
"651";"C";"Mike Richards";23;5,4;79;30;50;22;80
"652";"RW";"Mike Rupp";28;0,5;72;3;6;-2;9
"653";"C";"Mike Santorelli";23;0,05;7;0;0;-5;0
"654";"D";"Mike Sauer";21;0,03;3;0;0;-1;0
"655";"C";"Mike Sillinger";37;2,3;7;2;0;-5;2
"656";"G";"Mike Smith";26;0,95;41;0;1;0;1
"657";"D";"Mike Van Ryn";29;3,35;27;3;8;2;11
"658";"D";"Mike Vernace";22;0,07;12;0;0;-5;0
"659";"D";"Mike Weaver";30;0,7;58;0;7;-3;7
"660";"D";"Mike Weber";21;0,06;7;0;0;-3;0
"661";"LW";"Mike York";30;0,02;1;0;0;0;0
"662";"C";"Mike Zigomanis";27;0,65;22;2;4;-2;6
"663";"C";"Mikhail Grabovski";24;0,82;78;20;28;-8;48
"664";"RW";"Mikkel Boedker";19;1,73;78;11;17;-6;28
"665";"C";"Mikko Koivu";25;3,3;79;20;47;2;67
"666";"RW";"Mikko Lehtonen";21;0,01;1;0;0;0;0
"667";"RW";"Milan Hejduk";32;4;82;27;32;-19;59
"668";"D";"Milan Jurcina";25;0,91;79;3;11;1;14
"669";"LW";"Milan Lucic";20;0,85;72;17;25;17;42
"670";"LW";"Milan Michalek";24;3;77;23;34;11;57
"671";"RW";"Miroslav Satan";34;2,8;65;17;19;3;36
"672";"LW";"Mitch Fritz";28;0,13;20;0;0;-4;0
"673";"D";"Nate Guenin";26;0,01;1;0;0;0;0
"674";"C";"Nate Raduns";24;0,01;1;0;0;0;0
"675";"C";"Nate Thompson";24;0,5;43;2;2;-11;4
"676";"C";"Nathan Gerbe";21;0,16;10;0;1;3;1
"677";"C";"Nathan Horton";23;3,5;67;22;23;-5;45
"678";"D";"Nathan McIver";23;0,52;18;0;1;2;1
"679";"D";"Nathan Oystrick";26;0,58;53;4;8;-2;12
"680";"D";"Nathan Paetsch";25;0,8;23;2;4;3;6
"681";"D";"Nick Boynton";29;2,95;68;5;16;7;21
"682";"LW";"Nick Foligno";21;0,85;81;17;15;-10;32
"683";"D";"Nick Schultz";26;3,2;79;2;9;-4;11
"684";"C";"Nick Tarnasky";24;0,52;45;1;6;-1;7
"685";"C";"Nicklas Backstrom";21;2,4;82;22;66;16;88
"686";"RW";"Nicklas Bergfors";21;0,11;8;1;0;-1;1
"687";"D";"Nicklas Lidstrom";38;7,45;78;16;43;31;59
"688";"D";"Niclas Havelid";35;2,9;78;2;17;2;19
"689";"D";"Niclas Wallin";33;1,73;64;2;8;-1;10
"690";"LW";"Nigel Dawes";23;0,59;64;10;11;-6;21
"691";"C";"Nik Antropov";28;2,15;81;28;31;-14;59
"692";"C";"Nikita Filatov";18;0,63;8;4;0;3;4
"693";"G";"Niklas Backstrom";30;3,1;71;0;0;0;0
"694";"D";"Niklas Grossman";23;0,9;81;2;10;-8;12
"695";"LW";"Niklas Hagman";29;3;65;22;20;-5;42
"696";"D";"Niklas Hjalmarsson";21;0,2;21;1;2;4;3
"697";"D";"Niklas Kronwall";27;3;80;6;45;2;51
"698";"G";"Nikolai Khabibulin";35;6,75;42;0;2;0;2
"699";"LW";"Nikolai Kulemin";22;1,42;73;15;16;-8;31
"700";"LW";"Nikolai Zherdev";24;3,25;82;23;35;6;58
"701";"D";"Noah Welch";26;0,75;40;1;1;-9;2
"702";"G";"Olaf Kolzig";38;1,5;8;0;0;0;0
"703";"D";"Ole-Kristian Tollefsen";24;0,75;19;0;1;-4;1
"704";"C";"Olli Jokinen";30;5,25;76;29;28;-12;57
"705";"G";"Ondrej Pavelec";21;0,42;12;0;0;0;0
"706";"RW";"Oscar Moller";19;0,79;40;7;8;-3;15
"707";"LW";"Oskar Osala";21;0,02;2;0;0;-1;0
"708";"D";"Ossi Vaananen";28;1;49;1;10;8;11
"709";"RW";"Owen Nolan";36;2,75;59;25;20;5;45
"710";"LW";"P.J. Axelsson";33;1,85;75;6;24;-1;30
"711";"LW";"Pascal Dupuis";29;1,4;71;12;16;1;28
"712";"G";"Pascal Leclaire";26;3;12;0;1;0;1
"713";"C";"Pascal Pelletier";25;0,07;7;0;0;-4;0
"714";"RW";"Pat Dwyer";25;0,07;13;1;0;-2;1
"715";"LW";"Pat Rissmiller";30;0,29;2;0;0;-2;0
"716";"RW";"Patric Hornqvist";22;0,29;28;2;5;-3;7
"717";"C";"Patrice Bergeron";23;5;64;8;31;2;39
"718";"D";"Patrice Brisebois";37;1,5;62;5;13;-3;18
"719";"RW";"Patrick Davis";22;0;1;0;0;0;0
"720";"RW";"Patrick Eaves";24;1,1;74;6;8;7;14
"721";"RW";"Patrick Kaleta";22;0,5;51;4;5;1;9
"722";"RW";"Patrick Kane";20;3,73;80;25;45;-2;70
"723";"G";"Patrick Lalime";34;1;24;0;0;0;0
"724";"LW";"Patrick Marleau";29;6,3;76;38;33;16;71
"725";"LW";"Patrick O'Sullivan";23;4;81;16;27;-6;43
"726";"C";"Patrick Sharp";27;3,3;61;26;18;6;44
"727";"C";"Patrik Berglund";20;1,25;76;21;26;19;47
"728";"C";"Patrik Elias";32;6;77;31;47;18;78
"729";"LW";"Paul Bissonnette";23;0,15;15;0;1;-1;1
"730";"C";"Paul Gaustad";26;1,7;62;12;17;4;29
"731";"LW";"Paul Kariya";34;6;11;2;13;1;15
"732";"D";"Paul Mara";29;1,95;76;5;16;2;21
"733";"D";"Paul Martin";27;4;73;5;28;21;33
"734";"D";"Paul Ranger";24;0,95;42;2;11;-5;13
"735";"C";"Paul Stastny";23;0,85;45;11;25;-9;36
"736";"C";"Paul Szczechura";23;0,37;31;4;5;-1;9
"737";"C";"Pavel Datsyuk";30;6,7;81;32;65;34;97
"738";"D";"Pavel Kubina";31;5;82;14;26;-15;40
"739";"C";"Pavol Demitra";34;4;69;20;33;6;53
"740";"G";"Pekka Rinne";26;0,57;52;0;1;0;1
"741";"LW";"Per Ledin";30;0,02;3;0;0;-1;0
"742";"G";"Peter Budaj";26;0,8;56;0;1;0;1
"743";"D";"Peter Harrold";25;0,65;69;4;8;-13;12
"744";"G";"Peter Mannino";24;0,06;3;0;0;0;0
"745";"C";"Peter Mueller";20;1,7;72;13;23;-7;36
"746";"LW";"Peter Olvecky";23;0,22;31;2;5;1;7
"747";"C";"Peter Regin";22;0,06;11;1;1;0;2
"748";"RW";"Petr Prucha";26;1,6;47;6;13;-1;19
"749";"RW";"Petr Sykora";32;2,5;76;25;21;3;46
"750";"C";"Petr Vrana";23;0,17;16;1;0;-4;1
"751";"C";"Petteri Nokelainen";22;0,8;50;4;5;2;9
"752";"RW";"Phil Kessel";21;2,2;70;36;24;23;60
"753";"D";"Phil Oreskovic";21;0,06;10;1;1;-2;2
"754";"D";"Philippe Boucher";35;2,5;41;3;6;6;9
"755";"C";"Philippe Dupuis";23;0,06;8;0;0;-1;0
"756";"LW";"Pierre-Luc Leblond";23;0,11;8;0;1;3;1
"757";"C";"Pierre-Marc Bouchard";24;3,35;71;16;30;-5;46
"758";"LW";"Quintin Laing";29;0,07;1;0;0;1;0
"759";"C";"R.J. Umberger";26;3;82;26;20;-10;46
"760";"C";"Radek Bonk";32;1,6;66;9;16;-12;25
"761";"RW";"Radek Dvorak";31;1,6;81;15;21;0;36
"762";"D";"Radek Martinek";32;1,2;51;6;4;-16;10
"763";"LW";"Radek Smolenak";22;0,03;6;0;1;1;1
"764";"RW";"Radim Vrbata";27;0,98;18;3;3;-1;6
"765";"LW";"Raffi Torres";27;2,4;51;12;8;-4;20
"766";"LW";"Raitis Ivanans";29;0,6;76;2;0;-8;2
"767";"D";"Randy Jones";27;2,5;47;4;4;8;8
"768";"D";"Ray Macias";22;0,04;6;0;1;0;1
"769";"LW";"Ray Whitney";36;3,55;82;24;53;2;77
"770";"RW";"Raymond Sawada";23;0,04;5;1;0;-1;1
"771";"LW";"Rene Bourque";27;1,3;58;21;19;18;40
"772";"G";"Rick DiPietro";27;4,5;5;0;2;0;2
"773";"RW";"Rick Nash";24;6,5;78;40;39;11;79
"774";"C";"Rick Rypien";24;0,52;12;3;0;-3;3
"775";"C";"Rich Peverley";26;0,48;66;15;29;13;44
"776";"RW";"Richard Park";32;0,7;71;14;17;-13;31
"777";"D";"Richard Petiot";26;0,09;11;0;3;5;3
"778";"LW";"Richard Zednik";32;1,75;70;17;16;2;33
"779";"G";"Riku Helenius";20;0,02;1;0;0;0;0
"780";"RW";"Riley Armstrong";24;0,01;2;0;0;-1;0
"781";"LW";"Riley Cote";26;0,52;63;0;3;-7;3
"782";"D";"Rob Blake";39;5;73;10;35;15;45
"783";"D";"Rob Davison";28;0,56;23;0;2;-4;2
"784";"C";"Rob Niedermayer";34;2;79;14;7;-17;21
"785";"D";"Rob Scuderi";30;0,72;81;1;15;23;16
"786";"C";"Rob Schremp";22;0,06;4;0;3;2;3
"787";"C";"Robert Lang";38;4;50;18;21;6;39
"788";"RW";"Robert Nilsson";23;1,5;64;9;20;1;29
"789";"G";"Roberto Luongo";29;7;54;0;1;0;1
"790";"D";"Robyn Regehr";28;4,6;75;0;8;10;8
"791";"C";"Rod Brind'Amour";38;4;80;16;35;-23;51
"792";"D";"Roman Hamrlik";34;5,5;81;6;27;5;33
"793";"D";"Roman Polak";22;0,48;69;1;14;-15;15
"794";"D";"Ron Hainsey";27;4,5;81;6;33;-16;39
"795";"D";"Rostislav Klesla";26;1,65;34;1;8;2;9
"796";"C";"Rostislav Olesz";23;1,7;37;4;5;-5;9
"797";"LW";"Ruslan Fedotenko";29;2,25;65;16;23;18;39
"798";"D";"Ruslan Salei";34;3,02;70;4;17;-4;21
"799";"LW";"Ryan Bayda";28;0,48;70;5;7;2;12
"800";"RW";"Ryan Callahan";23;0,6;81;22;18;7;40
"801";"C";"Ryan Carter";25;0,52;48;3;6;3;9
"802";"LW";"Ryan Craig";26;0,78;54;2;4;-7;6
"803";"C";"Ryan Getzlaf";23;4,5;81;25;66;5;91
"804";"LW";"Ryan Hollweg";25;0,34;25;0;2;-7;2
"805";"C";"Ryan Johnson";32;1,1;62;2;7;1;9
"806";"LW";"Ryan Jones";24;0,92;46;7;10;1;17
"807";"C";"Ryan Kesler";24;1,75;82;26;33;8;59
"808";"LW";"Ryan Malone";29;6;70;26;19;4;45
"809";"G";"Ryan Miller";28;3,5;59;0;0;0;0
"810";"D";"Ryan O'Byrne";24;0,7;37;0;5;-7;5
"811";"D";"Ryan Parent";21;0,68;31;0;4;3;4
"812";"C";"Ryan Potulny";24;0,06;8;0;3;2;3
"813";"RW";"Ryan Shannon";25;0,29;35;8;12;-1;20
"814";"LW";"Ryan Smyth";32;7,25;77;26;33;-15;59
"815";"C";"Ryan Stone";23;0,02;2;0;0;1;0
"816";"D";"Ryan Suter";23;3,5;82;7;38;-16;45
"817";"C";"Ryan Vesce";26;0,05;10;0;0;-2;0
"818";"D";"Ryan Whitney";25;3;48;2;21;-14;23
"819";"LW";"Ryane Clowe";26;1,6;71;22;30;8;52
"820";"C";"Saku Koivu";34;4,75;65;16;34;4;50
"821";"C";"Sam Gagner";19;1,62;76;16;25;-1;41
"822";"D";"Sami Lepisto";24;0,04;7;0;4;-3;4
"823";"D";"Sami Salo";34;3,75;60;5;20;5;25
"824";"C";"Samuel Pahlsson";31;1,4;65;7;11;-17;18
"825";"G";"Scott Clemmensen";31;0,33;40;0;0;0;0
"826";"C";"Scott Gomez";29;8;77;16;42;-2;58
"827";"D";"Scott Hannan";29;4,5;81;1;9;-21;10
"828";"RW";"Scott Hartnell";26;4,7;82;30;30;14;60
"829";"D";"Scott Lehman";22;0,04;1;0;0;0;0
"830";"C";"Scott Nichol";34;0,75;43;4;6;0;10
"831";"D";"Scott Niedermayer";35;6,75;82;14;45;-8;59
"832";"RW";"Scott Walker";35;2,5;41;5;10;-4;15
"833";"LW";"Scottie Upshall";25;1,25;74;15;19;7;34
"834";"LW";"Sean Avery";28;3,5;41;8;14;6;22
"835";"LW";"Sean Bentivoglio";23;0;1;0;0;0;0
"836";"LW";"Sean Bergenheim";24;0,8;59;15;9;-2;24
"837";"D";"Sean Collins";25;0,16;15;1;1;1;2
"838";"D";"Sean O'Donnell";37;1,25;82;0;12;2;12
"839";"G";"Semyon Varlamov";20;0,16;6;0;0;0;0
"840";"C";"Sergei Fedorov";39;4;52;11;22;4;33
"841";"D";"Sergei Gonchar";34;6;25;6;13;6;19
"842";"RW";"Sergei Kostitsyn";21;0,67;56;8;15;-3;23
"843";"LW";"Sergei Samsonov";30;2,3;81;16;32;-8;48
"844";"D";"Sergei Zubov";38;5,35;10;0;4;-4;4
"845";"RW";"Shane Doan";32;4,55;82;31;42;5;73
"846";"D";"Shane Hnidy";33;0,76;65;3;9;6;12
"847";"D";"Shane O'Brien";25;1,02;77;0;10;5;10
"848";"D";"Shaone Morrisonn";26;1,98;72;3;10;4;13
"849";"C";"Shawn Horcoff";30;3,6;80;17;36;7;53
"850";"C";"Shawn Matthias";20;0,12;16;0;2;-3;2
"851";"LW";"Shawn Thornton";31;0,5;79;6;5;-2;11
"852";"D";"Shea Weber";23;4,5;81;23;30;1;53
"853";"RW";"Shean Donovan";33;0,6;65;5;5;-2;10
"854";"D";"Sheldon Brookbank";28;0,5;44;1;3;4;4
"855";"D";"Sheldon Souray";32;6,25;81;23;30;1;53
"856";"C";"Sidney Crosby";21;9;77;33;70;3;103
"857";"LW";"Simon Gagne";28;5,25;79;34;40;21;74
"858";"LW";"Slava Kozlov";36;3,85;82;26;50;-14;76
"859";"RW";"Spencer Machacek";20;0,01;2;0;0;0;0
"860";"D";"Staffan Kronwall";25;0,03;3;0;0;-1;0
"861";"D";"Stephane Robidas";31;1,5;72;3;23;10;26
"862";"LW";"Stephane Veilleux";27;0,86;81;13;10;-17;23
"863";"C";"Stephane Yelle";34;0,75;77;7;11;6;18
"864";"C";"Stephen Weiss";25;2,5;78;14;47;18;61
"865";"LW";"Steve Begin";30;1,3;62;7;5;-6;12
"866";"RW";"Steve Bernier";23;2,5;81;15;17;4;32
"867";"RW";"Steve Downie";21;0,27;29;3;3;-2;6
"868";"D";"Steve Eminger";25;0,94;71;5;21;-3;26
"869";"LW";"Steve MacIntyre";28;0,52;22;2;0;-2;2
"870";"G";"Steve Mason";20;0,85;61;0;0;0;0
"871";"D";"Steve Montador";29;0,8;78;4;17;17;21
"872";"LW";"Steve Ott";26;1,27;64;19;27;3;46
"873";"LW";"Steve Regier";24;0,04;8;3;1;-1;4
"874";"C";"Steve Reinprecht";32;2;73;14;27;0;41
"875";"D";"Steve Staios";35;2,9;80;2;12;-5;14
"876";"RW";"Steve Sullivan";34;3,2;41;11;21;2;32
"877";"G";"Steve Valiquette";31;0,72;15;0;1;0;1
"878";"D";"Steve Wagner";24;0,31;22;2;2;-5;4
"879";"RW";"Steven Goertzen";24;0,11;16;2;2;-2;4
"880";"C";"Steven Stamkos";18;3,73;79;23;23;-13;46
"881";"LW";"T.J. Galiardi";20;0,12;11;3;1;-4;4
"882";"C";"T.J. Hensick";23;0,73;61;4;17;-7;21
"883";"C";"T.J. Oshie";22;1,27;57;14;25;16;39
"884";"LW";"Tanner Glass";25;0,02;3;0;0;0;0
"885";"D";"Taylor Chorney";21;0,07;2;0;0;-4;0
"886";"LW";"Taylor Pyatt";27;1,57;69;10;9;0;19
"887";"LW";"Ted Purcell";23;0,64;40;4;12;-4;16
"888";"RW";"Teemu Selanne";38;3,25;65;27;27;-3;54
"889";"D";"Teppo Numminen";40;1,1;57;2;15;-4;17
"890";"D";"Theo Peckham";21;0,17;15;0;0;-1;0
"891";"D";"Thomas Pock";27;0,63;59;1;2;-17;3
"892";"LW";"Thomas Vanek";24;8;73;40;24;-1;64
"893";"C";"Tim Brent";24;0,01;2;0;0;0;0
"894";"D";"Tim Conboy";26;0,17;28;0;1;-1;1
"895";"C";"Tim Connolly";27;3,5;48;18;29;12;47
"896";"D";"Tim Gleason";25;2;70;0;12;3;12
"897";"RW";"Tim Jackman";27;0,5;69;5;7;-17;12
"898";"LW";"Tim Kennedy";22;0;1;0;0;0;0
"899";"LW";"Tim Sestito";24;0,01;1;0;0;0;0
"900";"C";"Tim Stapleton";26;0,03;4;1;0;-3;1
"901";"G";"Tim Thomas";34;1,1;54;0;1;0;1
"902";"LW";"Tim Wallace";24;0,09;16;0;2;2;2
"903";"G";"Tobias Stephan";24;0,48;10;0;1;0;1
"904";"D";"Toby Enstrom";24;0,9;82;5;27;14;32
"905";"C";"Toby Petersen";30;0,55;57;4;7;1;11
"906";"RW";"Todd Bertuzzi";33;1,95;66;15;29;-13;44
"907";"LW";"Todd Fedoruk";29;1;72;6;7;-9;13
"908";"C";"Todd Marchant";35;2,66;72;5;13;-2;18
"909";"C";"Todd White";33;2,35;82;22;51;-9;73
"910";"C";"Tom Cavanagh";26;0,16;17;1;1;-2;2
"911";"D";"Tom Gilbert";25;3,5;82;5;40;6;45
"912";"RW";"Tom Kostopoulos";29;0,87;78;8;14;-1;22
"913";"D";"Tom Poti";31;3,5;52;3;10;3;13
"914";"D";"Tom Preissing";30;2,16;22;3;4;-7;7
"915";"C";"Tom Wandell";21;0,11;14;1;2;-1;3
"916";"LW";"Tomas Fleischmann";24;0,72;73;19;18;-3;37
"917";"RW";"Tomas Holmstrom";35;2,25;53;14;23;18;37
"918";"D";"Tomas Kaberle";30;4,25;57;4;27;-8;31
"919";"C";"Tomas Kopecky";26;0,52;79;6;13;-7;19
"920";"D";"Tomas Mojzis";26;0,12;4;0;1;-1;1
"921";"C";"Tomas Plekanec";26;1,8;80;20;19;-9;39
"922";"C";"Tomas Plihal";25;0,5;64;5;8;-4;13
"923";"G";"Tomas Vokoun";32;5,5;59;0;1;0;1
"924";"D";"Toni Lydman";31;3,15;80;3;20;0;23
"925";"LW";"Travis Moen";26;0,92;82;7;9;-18;16
"926";"C";"Travis Zajac";23;0,98;82;20;42;33;62
"927";"RW";"Trent Hunter";28;2;55;14;17;-8;31
"928";"C";"Trent Whitfield";31;0,03;3;0;1;2;1
"929";"D";"Trevor Daley";25;2,1;75;7;18;2;25
"930";"C";"Trevor Lewis";21;0,06;6;1;2;0;3
"931";"C";"Trevor Smith";23;0,05;7;1;0;-3;1
"932";"RW";"Troy Bodie";23;0,06;4;0;0;0;0
"933";"RW";"Troy Brouwer";23;0,62;69;10;16;7;26
"934";"C";"Tuomo Ruutu";25;2,25;79;26;28;0;54
"935";"G";"Tuukka Rask";21;0,16;1;0;0;0;0
"936";"G";"Ty Conklin";32;0,75;40;0;0;0;0
"937";"D";"Ty Wishart";20;0,04;5;0;1;0;1
"938";"C";"Tyler Arnason";29;1,75;71;5;17;-16;22
"939";"RW";"Tyler Kennedy";22;0,54;67;15;20;15;35
"940";"D";"Tyler Sloan";27;0,17;26;1;4;4;5
"941";"D";"Tyson Strachan";24;0,37;30;0;3;8;3
"942";"C";"Vaclav Prospal";33;3,5;82;19;26;-20;45
"943";"C";"Valtteri Filppula";24;2;80;12;28;9;40
"944";"C";"Vernon Fiddler";28;0,9;78;11;6;-13;17
"945";"G";"Vesa Toskala";31;4;53;0;0;0;0
"946";"C";"Viktor Kozlov";33;2,5;67;13;28;-9;41
"947";"F";"Viktor Tikhonov";20;1,14;61;8;8;-3;16
"948";"D";"Ville Koistinen";26;0,7;38;3;8;0;11
"949";"RW";"Ville Leino";25;0,15;13;5;4;5;9
"950";"LW";"Ville Peltonen";35;1,2;79;12;19;6;31
"951";"C";"Vincent Lecavalier";28;7,17;77;29;38;-9;67
"952";"D";"Vladimir Mihalik";21;0,07;11;0;3;-3;3
"953";"C";"Vladimir Sobotka";21;0,32;25;1;4;-10;5
"954";"F";"Wade Belak";32;0,65;53;0;2;-1;2
"955";"F";"Wade Brookbank";31;0,31;27;1;0;0;1
"956";"G";"Wade Dubielewicz";29;0,23;3;0;0;0;0
"957";"D";"Wade Redden";31;8;81;3;23;-5;26
"958";"C";"Warren Peters";26;0,1;16;1;0;-2;1
"959";"C";"Wayne Primeau";32;1,4;24;0;4;-3;4
"960";"RW";"Wayne Simmonds";20;0,82;82;9;14;-8;23
"961";"D";"Wes O'Neill";22;0,03;3;0;0;-2;0
"962";"D";"Willie Mitchell";31;3,5;82;3;20;29;23
"963";"LW";"Wojtek Wolski";22;2,5;78;14;28;-13;42
"964";"C";"Yan Stastny";26;0,37;34;3;4;-14;7
"965";"G";"Yann Danis";27;0,43;31;0;0;0;0
"966";"D";"Yannick Weber";20;0,08;3;0;1;-1;1
"967";"C";"Zack Smith";20;0,01;1;0;0;0;0
"968";"RW";"Zack Stortini";23;0,6;52;6;5;-3;11
"969";"D";"Zach Bogosian";18;2,73;47;9;10;11;19
"970";"C";"Zach Boychuk";19;0,05;2;0;0;0;0
"971";"LW";"Zach Parise";24;2,5;82;45;49;30;94
"972";"D";"Zbynek Michalek";26;1,4;82;6;21;-13;27
"973";"D";"Zdeno Chara";31;7,5;80;19;31;23;50
"974";"C";"Zenon Konopka";28;0,04;7;0;1;-1;1
